Orthogroup	Allma1_GeneCatalog_proteins_20131203.aa	Blabri1_GeneCatalog_proteins_20160901.aa	Blastocladiella_emersonii_ATCC_22665.proteins	Catan2_GeneCatalog_proteins_20160412.aa	Chytriomyces_confervae_GCA_006535975_ASM653597v1_protein	Parsed1_GeneCatalog_proteins_20170905.aa	Rhihy1_GeneCatalog_proteins_20151219.aa	Total
OG0000000	0	0	0	0	0	215	0	215
OG0000001	13	14	11	13	33	24	37	145
OG0000002	43	17	23	40	1	6	0	130
OG0000003	18	5	16	17	27	1	36	120
OG0000004	0	120	0	0	0	0	0	120
OG0000005	20	20	13	27	0	0	0	80
OG0000006	0	0	0	0	34	0	42	76
OG0000007	0	0	0	0	1	0	71	72
OG0000008	0	0	69	0	0	0	0	69
OG0000009	0	0	0	0	10	0	59	69
OG0000010	34	6	14	14	0	0	0	68
OG0000011	7	2	3	3	22	8	21	66
OG0000012	0	0	0	0	0	0	66	66
OG0000013	20	11	3	1	25	1	3	64
OG0000014	0	0	0	0	0	64	0	64
OG0000015	21	10	12	16	0	0	0	59
OG0000016	3	32	8	2	5	4	5	59
OG0000017	0	0	0	0	0	0	58	58
OG0000018	1	0	0	53	0	1	0	55
OG0000019	0	0	0	0	0	0	52	52
OG0000020	4	5	3	3	10	10	16	51
OG0000021	0	51	0	0	0	0	0	51
OG0000022	0	0	0	0	51	0	0	51
OG0000023	17	1	4	3	7	10	8	50
OG0000024	0	0	0	50	0	0	0	50
OG0000025	0	0	0	0	0	0	50	50
OG0000026	1	1	1	3	0	43	0	49
OG0000027	48	0	0	0	0	0	0	48
OG0000028	13	0	17	13	1	3	1	48
OG0000029	47	0	0	0	0	0	0	47
OG0000030	0	1	0	1	12	2	31	47
OG0000031	0	0	0	0	0	0	47	47
OG0000032	0	0	0	0	0	0	47	47
OG0000033	1	0	43	0	1	0	1	46
OG0000034	16	11	9	3	2	1	3	45
OG0000035	0	0	0	0	12	0	33	45
OG0000036	0	0	0	0	5	0	39	44
OG0000037	0	0	0	0	0	0	44	44
OG0000038	9	4	5	5	0	18	2	43
OG0000039	1	0	0	0	5	0	37	43
OG0000040	12	4	6	12	0	8	0	42
OG0000041	0	42	0	0	0	0	0	42
OG0000042	13	7	8	10	0	3	0	41
OG0000043	40	1	0	0	0	0	0	41
OG0000044	5	4	3	6	4	10	9	41
OG0000045	6	4	4	4	8	5	10	41
OG0000046	18	6	1	4	4	1	7	41
OG0000047	0	0	0	0	35	0	6	41
OG0000048	0	0	0	0	0	0	41	41
OG0000049	7	7	6	9	4	0	7	40
OG0000050	2	0	3	5	14	8	8	40
OG0000051	10	14	3	8	3	1	1	40
OG0000052	0	0	0	0	0	40	0	40
OG0000053	0	0	0	0	24	0	15	39
OG0000054	11	7	8	8	0	4	0	38
OG0000055	38	0	0	0	0	0	0	38
OG0000056	5	4	8	13	0	8	0	38
OG0000057	0	0	0	0	9	0	29	38
OG0000058	10	7	11	3	1	3	2	37
OG0000059	10	5	4	6	4	4	4	37
OG0000060	3	3	5	5	10	0	11	37
OG0000061	0	3	8	7	0	19	0	37
OG0000062	0	0	37	0	0	0	0	37
OG0000063	18	4	2	5	1	0	6	36
OG0000064	5	10	2	10	2	0	7	36
OG0000065	5	4	3	1	8	0	15	36
OG0000066	8	2	2	2	4	1	17	36
OG0000067	1	9	22	4	0	0	0	36
OG0000068	0	0	2	0	33	0	1	36
OG0000069	8	2	3	4	8	3	7	35
OG0000070	17	5	4	3	2	3	1	35
OG0000071	6	3	2	13	4	1	6	35
OG0000072	0	0	0	0	3	0	32	35
OG0000073	9	4	2	4	6	5	4	34
OG0000074	11	5	4	6	1	6	1	34
OG0000075	7	5	6	4	4	5	3	34
OG0000076	9	5	5	4	4	2	5	34
OG0000077	0	34	0	0	0	0	0	34
OG0000078	0	0	34	0	0	0	0	34
OG0000079	0	0	0	0	0	34	0	34
OG0000080	33	0	0	0	0	0	0	33
OG0000081	5	2	2	2	9	3	10	33
OG0000082	7	1	4	3	7	2	9	33
OG0000083	8	5	5	8	1	1	5	33
OG0000084	11	2	3	2	9	1	5	33
OG0000085	7	2	1	2	6	2	13	33
OG0000086	18	3	3	4	1	4	0	33
OG0000087	0	1	0	0	0	32	0	33
OG0000088	0	0	0	0	0	0	33	33
OG0000089	6	3	3	5	5	6	4	32
OG0000090	10	4	5	11	0	2	0	32
OG0000091	13	2	8	9	0	0	0	32
OG0000092	8	4	3	3	7	1	6	32
OG0000093	2	2	3	1	6	3	15	32
OG0000094	0	10	2	6	3	0	11	32
OG0000095	0	0	32	0	0	0	0	32
OG0000096	0	0	0	0	0	32	0	32
OG0000097	6	4	9	8	0	3	1	31
OG0000098	0	31	0	0	0	0	0	31
OG0000099	0	0	31	0	0	0	0	31
OG0000100	0	0	0	0	14	0	17	31
OG0000101	0	0	0	0	0	0	31	31
OG0000102	30	0	0	0	0	0	0	30
OG0000103	7	4	8	6	1	3	1	30
OG0000104	5	2	2	2	6	5	8	30
OG0000105	14	0	1	1	6	1	7	30
OG0000106	15	6	3	5	0	1	0	30
OG0000107	8	4	4	4	4	2	4	30
OG0000108	6	7	3	3	4	1	6	30
OG0000109	7	4	7	7	2	3	0	30
OG0000110	9	1	7	4	1	7	1	30
OG0000111	5	4	3	4	5	4	5	30
OG0000112	0	0	0	0	0	0	30	30
OG0000113	3	3	6	3	2	3	9	29
OG0000114	8	3	3	2	7	3	3	29
OG0000115	2	2	6	4	4	4	7	29
OG0000116	4	2	0	3	9	3	8	29
OG0000117	1	0	0	0	5	1	22	29
OG0000118	0	0	0	0	2	0	27	29
OG0000119	0	0	0	0	1	0	28	29
OG0000120	0	0	0	0	0	29	0	29
OG0000121	0	0	0	0	0	0	29	29
OG0000122	15	2	5	2	0	1	3	28
OG0000123	3	3	4	4	4	3	7	28
OG0000124	7	2	4	2	5	1	7	28
OG0000125	6	4	5	2	2	5	4	28
OG0000126	4	8	0	5	0	11	0	28
OG0000127	1	1	0	5	16	0	5	28
OG0000128	0	0	28	0	0	0	0	28
OG0000129	0	0	0	0	11	0	17	28
OG0000130	0	0	0	0	1	0	27	28
OG0000131	2	2	1	0	3	2	17	27
OG0000132	9	5	4	6	1	0	2	27
OG0000133	3	0	3	6	4	3	8	27
OG0000134	7	7	5	4	0	4	0	27
OG0000135	6	3	3	3	5	1	6	27
OG0000136	16	1	2	5	0	3	0	27
OG0000137	10	1	2	2	5	2	5	27
OG0000138	3	5	2	0	5	0	12	27
OG0000139	0	2	0	25	0	0	0	27
OG0000140	0	0	0	27	0	0	0	27
OG0000141	0	0	0	27	0	0	0	27
OG0000142	0	0	0	0	17	0	10	27
OG0000143	25	0	0	1	0	0	0	26
OG0000144	4	3	4	4	3	5	3	26
OG0000145	19	3	2	2	0	0	0	26
OG0000146	6	1	1	4	1	5	8	26
OG0000147	2	2	11	1	4	2	4	26
OG0000148	8	6	4	3	2	1	2	26
OG0000149	1	1	3	5	8	3	5	26
OG0000150	2	0	1	2	7	0	14	26
OG0000151	8	7	4	2	2	2	1	26
OG0000152	3	3	1	1	4	1	13	26
OG0000153	0	1	24	1	0	0	0	26
OG0000154	0	0	26	0	0	0	0	26
OG0000155	0	0	26	0	0	0	0	26
OG0000156	0	0	0	0	0	0	26	26
OG0000157	8	3	4	1	4	1	4	25
OG0000158	3	4	4	3	4	3	4	25
OG0000159	12	3	2	2	1	4	1	25
OG0000160	2	1	1	1	2	1	17	25
OG0000161	2	0	1	3	6	0	13	25
OG0000162	4	4	3	4	3	5	2	25
OG0000163	2	5	2	5	6	1	4	25
OG0000164	0	20	1	4	0	0	0	25
OG0000165	0	0	25	0	0	0	0	25
OG0000166	0	0	1	0	2	1	21	25
OG0000167	0	0	25	0	0	0	0	25
OG0000168	0	0	25	0	0	0	0	25
OG0000169	0	0	0	0	2	0	23	25
OG0000170	0	0	0	0	0	0	25	25
OG0000171	9	2	2	2	3	1	5	24
OG0000172	9	2	2	3	4	1	3	24
OG0000173	2	0	0	22	0	0	0	24
OG0000174	4	3	9	7	0	1	0	24
OG0000175	2	5	2	8	3	0	4	24
OG0000176	2	1	1	1	7	1	11	24
OG0000177	10	0	12	2	0	0	0	24
OG0000178	2	1	4	12	3	2	0	24
OG0000179	6	5	2	1	3	5	2	24
OG0000180	1	2	20	1	0	0	0	24
OG0000181	0	21	0	1	0	0	2	24
OG0000182	0	0	24	0	0	0	0	24
OG0000183	0	0	12	7	0	5	0	24
OG0000184	0	0	0	24	0	0	0	24
OG0000185	0	0	0	0	14	1	9	24
OG0000186	0	0	0	0	0	0	24	24
OG0000187	23	0	0	0	0	0	0	23
OG0000188	6	3	3	3	3	2	3	23
OG0000189	5	6	4	6	0	2	0	23
OG0000190	7	2	2	2	3	3	4	23
OG0000191	3	3	2	4	3	4	4	23
OG0000192	1	0	22	0	0	0	0	23
OG0000193	4	2	4	3	3	3	4	23
OG0000194	23	0	0	0	0	0	0	23
OG0000195	6	3	3	3	3	1	4	23
OG0000196	6	6	3	3	1	1	3	23
OG0000197	2	2	2	1	7	3	6	23
OG0000198	2	9	4	8	0	0	0	23
OG0000199	6	1	8	8	0	0	0	23
OG0000200	3	4	4	2	2	4	4	23
OG0000201	0	5	15	3	0	0	0	23
OG0000202	0	0	23	0	0	0	0	23
OG0000203	0	0	0	23	0	0	0	23
OG0000204	7	3	1	4	3	2	2	22
OG0000205	4	4	2	4	2	3	3	22
OG0000206	3	2	3	1	1	3	9	22
OG0000207	10	5	3	4	0	0	0	22
OG0000208	4	4	2	2	3	2	5	22
OG0000209	2	3	1	2	4	1	9	22
OG0000210	10	2	6	4	0	0	0	22
OG0000211	3	3	5	6	0	2	3	22
OG0000212	4	5	6	2	3	1	1	22
OG0000213	7	6	4	4	0	0	1	22
OG0000214	2	8	10	2	0	0	0	22
OG0000215	0	19	2	1	0	0	0	22
OG0000216	0	12	3	5	0	0	2	22
OG0000217	0	22	0	0	0	0	0	22
OG0000218	0	22	0	0	0	0	0	22
OG0000219	0	0	22	0	0	0	0	22
OG0000220	0	0	0	22	0	0	0	22
OG0000221	0	0	0	0	1	0	21	22
OG0000222	0	0	0	0	9	1	12	22
OG0000223	0	0	0	0	0	22	0	22
OG0000224	0	0	0	0	0	22	0	22
OG0000225	0	0	0	0	0	0	22	22
OG0000226	6	2	2	2	4	1	4	21
OG0000227	4	2	3	2	4	2	4	21
OG0000228	6	2	2	3	3	2	3	21
OG0000229	6	2	2	2	4	2	3	21
OG0000230	3	1	1	3	4	1	8	21
OG0000231	9	2	2	2	2	3	1	21
OG0000232	5	2	1	1	4	2	6	21
OG0000233	3	1	2	1	2	2	10	21
OG0000234	3	1	2	1	6	1	7	21
OG0000235	7	3	2	3	4	1	1	21
OG0000236	21	0	0	0	0	0	0	21
OG0000237	3	1	1	1	3	1	11	21
OG0000238	2	9	1	3	1	3	2	21
OG0000239	5	5	2	3	2	2	2	21
OG0000240	7	2	2	2	4	2	2	21
OG0000241	5	2	2	3	2	3	4	21
OG0000242	3	3	2	2	4	2	5	21
OG0000243	2	1	1	1	1	8	7	21
OG0000244	4	2	2	2	4	3	4	21
OG0000245	7	2	2	2	1	4	3	21
OG0000246	9	3	2	3	1	2	1	21
OG0000247	10	2	1	2	1	2	3	21
OG0000248	7	1	4	2	2	1	4	21
OG0000249	2	3	2	9	0	5	0	21
OG0000250	5	2	2	2	4	2	4	21
OG0000251	2	1	1	1	5	2	9	21
OG0000252	4	9	3	2	0	1	2	21
OG0000253	2	4	2	6	2	1	4	21
OG0000254	3	3	2	3	3	2	5	21
OG0000255	0	2	17	2	0	0	0	21
OG0000256	0	21	0	0	0	0	0	21
OG0000257	0	0	21	0	0	0	0	21
OG0000258	0	0	1	0	3	0	17	21
OG0000259	0	0	0	21	0	0	0	21
OG0000260	0	0	0	21	0	0	0	21
OG0000261	0	0	0	0	11	0	10	21
OG0000262	0	0	0	0	3	0	18	21
OG0000263	0	0	0	0	0	0	21	21
OG0000264	0	0	0	0	0	0	21	21
OG0000265	0	0	0	0	0	0	21	21
OG0000266	0	0	0	0	0	0	21	21
OG0000267	0	0	0	0	0	0	21	21
OG0000268	5	4	2	4	2	2	1	20
OG0000269	4	1	1	2	2	6	4	20
OG0000270	3	2	3	3	2	5	2	20
OG0000271	19	0	0	1	0	0	0	20
OG0000272	4	3	3	2	2	2	4	20
OG0000273	1	0	19	0	0	0	0	20
OG0000274	4	2	2	1	2	3	6	20
OG0000275	8	9	2	1	0	0	0	20
OG0000276	2	1	2	0	6	3	6	20
OG0000277	3	3	3	3	4	1	3	20
OG0000278	9	1	1	1	1	1	6	20
OG0000279	3	3	1	3	4	4	2	20
OG0000280	5	0	7	7	0	0	1	20
OG0000281	3	3	2	2	2	5	3	20
OG0000282	5	2	3	3	1	2	4	20
OG0000283	4	3	2	3	2	3	3	20
OG0000284	6	2	1	2	2	2	5	20
OG0000285	8	3	1	3	2	1	2	20
OG0000286	5	2	2	2	4	2	3	20
OG0000287	2	4	1	1	6	1	5	20
OG0000288	2	1	2	1	5	2	7	20
OG0000289	5	5	2	8	0	0	0	20
OG0000290	3	6	4	6	0	1	0	20
OG0000291	5	2	2	2	3	4	2	20
OG0000292	2	0	1	1	2	1	13	20
OG0000293	3	4	1	2	2	2	6	20
OG0000294	4	1	1	1	5	1	7	20
OG0000295	2	1	5	8	3	1	0	20
OG0000296	0	1	3	1	1	14	0	20
OG0000297	0	0	20	0	0	0	0	20
OG0000298	0	0	0	20	0	0	0	20
OG0000299	0	0	0	1	2	2	15	20
OG0000300	0	0	0	0	10	0	10	20
OG0000301	0	0	0	0	3	0	17	20
OG0000302	0	0	0	0	2	2	16	20
OG0000303	0	0	0	0	0	0	20	20
OG0000304	0	0	0	0	0	0	20	20
OG0000305	0	0	0	0	0	0	20	20
OG0000306	0	0	0	0	0	0	20	20
OG0000307	0	0	0	0	0	0	20	20
OG0000308	4	1	2	1	5	1	5	19
OG0000309	4	1	1	1	3	4	5	19
OG0000310	4	1	3	2	2	1	6	19
OG0000311	4	2	1	2	5	1	4	19
OG0000312	6	2	2	3	4	1	1	19
OG0000313	9	3	2	3	1	1	0	19
OG0000314	6	3	1	2	3	1	3	19
OG0000315	10	1	2	2	0	0	4	19
OG0000316	6	1	4	1	4	1	2	19
OG0000317	2	2	10	5	0	0	0	19
OG0000318	5	3	1	1	2	3	4	19
OG0000319	4	2	2	3	2	2	4	19
OG0000320	3	2	2	3	4	2	3	19
OG0000321	4	2	2	2	4	2	3	19
OG0000322	4	2	2	2	2	2	5	19
OG0000323	16	1	1	1	0	0	0	19
OG0000324	5	4	1	0	7	0	2	19
OG0000325	4	4	4	3	2	1	1	19
OG0000326	3	3	4	2	0	6	1	19
OG0000327	2	1	3	1	6	2	4	19
OG0000328	19	0	0	0	0	0	0	19
OG0000329	4	1	1	1	9	1	2	19
OG0000330	7	2	1	2	3	1	3	19
OG0000331	4	2	0	3	3	0	7	19
OG0000332	3	1	1	1	6	1	6	19
OG0000333	2	1	1	1	5	1	8	19
OG0000334	0	19	0	0	0	0	0	19
OG0000335	0	19	0	0	0	0	0	19
OG0000336	0	1	16	1	0	1	0	19
OG0000337	0	0	0	19	0	0	0	19
OG0000338	0	0	0	0	6	0	13	19
OG0000339	0	0	0	0	8	0	11	19
OG0000340	0	0	0	0	1	0	18	19
OG0000341	0	0	0	0	0	19	0	19
OG0000342	0	0	0	0	0	0	19	19
OG0000343	0	0	0	0	0	0	19	19
OG0000344	5	2	2	2	3	2	2	18
OG0000345	5	1	1	2	2	2	5	18
OG0000346	4	2	1	4	3	1	3	18
OG0000347	6	2	2	2	2	2	2	18
OG0000348	5	2	2	2	2	2	3	18
OG0000349	4	2	1	2	2	1	6	18
OG0000350	4	1	1	1	5	2	4	18
OG0000351	17	0	0	1	0	0	0	18
OG0000352	2	2	2	10	0	2	0	18
OG0000353	8	1	5	3	0	1	0	18
OG0000354	4	2	3	2	3	2	2	18
OG0000355	8	2	3	2	1	1	1	18
OG0000356	2	4	1	1	2	1	7	18
OG0000357	4	2	2	2	2	2	4	18
OG0000358	2	1	1	1	4	2	7	18
OG0000359	10	1	3	4	0	0	0	18
OG0000360	4	1	2	1	3	3	4	18
OG0000361	3	3	1	2	3	1	5	18
OG0000362	2	2	1	2	1	1	9	18
OG0000363	3	1	5	1	2	2	4	18
OG0000364	4	2	3	1	3	0	5	18
OG0000365	4	2	2	1	5	2	2	18
OG0000366	14	1	1	1	0	0	1	18
OG0000367	4	3	3	3	0	3	2	18
OG0000368	8	2	1	1	1	3	2	18
OG0000369	3	0	0	0	5	1	9	18
OG0000370	4	2	1	2	3	3	3	18
OG0000371	5	1	1	1	3	2	5	18
OG0000372	3	1	1	10	1	1	1	18
OG0000373	0	0	0	18	0	0	0	18
OG0000374	0	0	0	0	1	0	17	18
OG0000375	0	0	0	0	0	18	0	18
OG0000376	0	0	0	0	0	0	18	18
OG0000377	0	0	0	0	0	0	18	18
OG0000378	0	0	0	0	0	0	18	18
OG0000379	6	1	1	1	4	1	3	17
OG0000380	10	3	1	1	0	0	2	17
OG0000381	8	1	1	4	0	0	3	17
OG0000382	3	3	2	3	3	2	1	17
OG0000383	4	1	1	1	6	2	2	17
OG0000384	4	3	2	2	2	2	2	17
OG0000385	6	1	2	3	1	1	3	17
OG0000386	4	1	2	1	5	1	3	17
OG0000387	1	1	1	2	1	2	9	17
OG0000388	8	1	1	2	3	1	1	17
OG0000389	7	2	4	3	0	1	0	17
OG0000390	3	0	1	4	0	6	3	17
OG0000391	17	0	0	0	0	0	0	17
OG0000392	10	1	1	1	2	1	1	17
OG0000393	8	2	3	3	0	1	0	17
OG0000394	6	1	1	1	4	2	2	17
OG0000395	4	1	2	1	1	2	6	17
OG0000396	2	3	5	2	0	5	0	17
OG0000397	6	2	2	3	2	1	1	17
OG0000398	5	0	0	12	0	0	0	17
OG0000399	11	1	1	4	0	0	0	17
OG0000400	3	4	2	2	2	2	2	17
OG0000401	4	1	1	1	3	1	6	17
OG0000402	1	3	1	2	2	7	1	17
OG0000403	4	1	1	2	2	1	6	17
OG0000404	2	1	2	1	4	1	6	17
OG0000405	2	0	11	4	0	0	0	17
OG0000406	3	1	1	1	5	2	4	17
OG0000407	4	4	2	5	0	1	1	17
OG0000408	4	2	2	3	2	2	2	17
OG0000409	1	2	3	2	3	1	5	17
OG0000410	4	2	3	3	0	4	1	17
OG0000411	3	2	2	1	3	1	5	17
OG0000412	17	0	0	0	0	0	0	17
OG0000413	3	2	1	3	2	1	5	17
OG0000414	4	13	0	0	0	0	0	17
OG0000415	8	1	3	3	0	2	0	17
OG0000416	2	2	1	1	5	0	6	17
OG0000417	2	1	1	1	4	1	7	17
OG0000418	3	2	2	2	4	2	2	17
OG0000419	5	1	1	2	1	2	5	17
OG0000420	2	2	2	3	2	2	4	17
OG0000421	0	17	0	0	0	0	0	17
OG0000422	0	0	17	0	0	0	0	17
OG0000423	0	0	17	0	0	0	0	17
OG0000424	0	0	17	0	0	0	0	17
OG0000425	0	0	16	1	0	0	0	17
OG0000426	0	0	17	0	0	0	0	17
OG0000427	0	0	0	17	0	0	0	17
OG0000428	0	0	0	17	0	0	0	17
OG0000429	0	0	0	0	16	0	1	17
OG0000430	0	0	0	0	5	3	9	17
OG0000431	0	0	0	0	7	0	10	17
OG0000432	0	0	0	0	9	0	8	17
OG0000433	0	0	0	0	0	17	0	17
OG0000434	0	0	0	0	0	0	17	17
OG0000435	0	0	0	0	0	0	17	17
OG0000436	0	0	0	0	0	0	17	17
OG0000437	0	0	0	0	0	0	17	17
OG0000438	5	5	2	2	0	2	0	16
OG0000439	4	7	2	3	0	0	0	16
OG0000440	2	1	1	2	5	2	3	16
OG0000441	4	2	2	2	2	2	2	16
OG0000442	4	2	2	2	1	3	2	16
OG0000443	6	3	2	3	0	0	2	16
OG0000444	3	1	1	4	3	1	3	16
OG0000445	3	6	2	1	1	2	1	16
OG0000446	9	2	2	2	0	1	0	16
OG0000447	4	3	2	4	0	3	0	16
OG0000448	4	2	2	3	1	1	3	16
OG0000449	2	1	4	2	2	1	4	16
OG0000450	8	3	1	1	0	1	2	16
OG0000451	15	0	0	0	0	0	1	16
OG0000452	5	2	1	3	2	1	2	16
OG0000453	7	1	1	1	1	1	4	16
OG0000454	6	2	2	2	2	1	1	16
OG0000455	2	0	1	1	3	1	8	16
OG0000456	4	3	3	2	0	1	3	16
OG0000457	3	4	3	1	0	1	4	16
OG0000458	2	1	1	1	1	7	3	16
OG0000459	5	1	2	1	2	2	3	16
OG0000460	4	1	1	1	3	2	4	16
OG0000461	2	4	2	2	0	6	0	16
OG0000462	4	2	2	1	1	3	3	16
OG0000463	2	4	1	2	1	2	4	16
OG0000464	3	2	1	1	2	2	5	16
OG0000465	4	1	1	3	1	3	3	16
OG0000466	3	3	2	4	0	1	3	16
OG0000467	6	1	1	1	3	1	3	16
OG0000468	4	1	1	1	3	1	5	16
OG0000469	4	1	1	1	2	5	2	16
OG0000470	4	2	1	1	3	3	2	16
OG0000471	4	2	2	2	4	1	1	16
OG0000472	1	1	1	2	4	1	6	16
OG0000473	3	2	2	2	2	1	4	16
OG0000474	4	1	1	1	2	2	5	16
OG0000475	1	1	2	1	5	2	4	16
OG0000476	1	0	0	0	1	0	14	16
OG0000477	0	16	0	0	0	0	0	16
OG0000478	0	12	0	4	0	0	0	16
OG0000479	0	1	0	0	10	0	5	16
OG0000480	0	0	16	0	0	0	0	16
OG0000481	0	0	0	0	16	0	0	16
OG0000482	0	0	0	0	7	4	5	16
OG0000483	0	0	0	0	16	0	0	16
OG0000484	0	0	0	0	5	4	7	16
OG0000485	0	0	0	0	2	4	10	16
OG0000486	0	0	0	0	0	16	0	16
OG0000487	0	0	0	0	0	0	16	16
OG0000488	0	0	0	0	0	0	16	16
OG0000489	0	0	0	0	0	0	16	16
OG0000490	0	0	0	0	0	0	16	16
OG0000491	0	0	0	0	0	0	16	16
OG0000492	4	0	9	0	1	0	1	15
OG0000493	7	1	1	1	0	5	0	15
OG0000494	10	0	1	0	2	0	2	15
OG0000495	6	1	2	2	1	2	1	15
OG0000496	4	1	2	2	2	2	2	15
OG0000497	3	7	2	3	0	0	0	15
OG0000498	6	2	1	1	2	1	2	15
OG0000499	8	1	1	1	1	2	1	15
OG0000500	5	1	2	1	1	1	4	15
OG0000501	5	2	2	2	1	2	1	15
OG0000502	1	2	2	2	3	1	4	15
OG0000503	5	2	2	2	0	2	2	15
OG0000504	4	1	1	2	3	2	2	15
OG0000505	2	1	1	1	2	2	6	15
OG0000506	3	1	2	2	3	2	2	15
OG0000507	2	1	1	4	3	0	4	15
OG0000508	4	3	3	3	0	2	0	15
OG0000509	9	1	2	3	0	0	0	15
OG0000510	5	2	3	2	1	1	1	15
OG0000511	4	2	2	1	1	2	3	15
OG0000512	3	1	2	2	0	4	3	15
OG0000513	4	1	1	2	3	1	3	15
OG0000514	6	5	2	1	0	1	0	15
OG0000515	5	3	3	2	0	2	0	15
OG0000516	4	2	2	3	2	1	1	15
OG0000517	2	0	2	0	3	4	4	15
OG0000518	15	0	0	0	0	0	0	15
OG0000519	4	2	1	2	3	1	2	15
OG0000520	2	2	2	2	2	2	3	15
OG0000521	2	1	4	1	4	1	2	15
OG0000522	3	2	2	2	2	2	2	15
OG0000523	3	2	2	2	2	2	2	15
OG0000524	3	4	1	1	3	1	2	15
OG0000525	2	1	2	1	2	1	6	15
OG0000526	4	2	2	2	2	2	1	15
OG0000527	5	1	1	4	0	4	0	15
OG0000528	4	1	1	2	2	0	5	15
OG0000529	2	2	1	1	0	1	8	15
OG0000530	3	1	1	1	3	2	4	15
OG0000531	4	2	5	3	0	1	0	15
OG0000532	2	1	1	2	4	1	4	15
OG0000533	6	4	4	1	0	0	0	15
OG0000534	5	2	2	2	1	2	1	15
OG0000535	4	3	3	2	1	1	1	15
OG0000536	3	1	2	1	3	1	4	15
OG0000537	2	1	1	2	1	0	8	15
OG0000538	2	3	3	1	1	2	3	15
OG0000539	4	2	2	1	2	2	2	15
OG0000540	3	2	5	2	1	1	1	15
OG0000541	6	0	2	2	0	5	0	15
OG0000542	2	1	1	1	1	2	7	15
OG0000543	2	2	1	3	1	0	6	15
OG0000544	1	2	2	3	1	4	2	15
OG0000545	1	2	2	3	2	2	3	15
OG0000546	0	2	1	1	2	2	7	15
OG0000547	0	0	15	0	0	0	0	15
OG0000548	0	0	2	1	8	2	2	15
OG0000549	0	0	1	4	0	1	9	15
OG0000550	0	0	0	2	7	1	5	15
OG0000551	0	0	0	15	0	0	0	15
OG0000552	0	0	0	1	0	0	14	15
OG0000553	0	0	0	0	10	0	5	15
OG0000554	0	0	0	0	8	0	7	15
OG0000555	0	0	0	0	4	0	11	15
OG0000556	0	0	0	0	2	3	10	15
OG0000557	0	0	0	0	1	0	14	15
OG0000558	0	0	0	0	8	0	7	15
OG0000559	0	0	0	0	7	0	8	15
OG0000560	0	0	0	0	0	0	15	15
OG0000561	0	0	0	0	0	0	15	15
OG0000562	0	0	0	0	0	0	15	15
OG0000563	0	0	0	0	0	0	15	15
OG0000564	0	0	0	0	0	0	15	15
OG0000565	0	0	0	0	0	0	15	15
OG0000566	0	0	0	0	0	0	15	15
OG0000567	0	0	0	0	0	0	15	15
OG0000568	2	2	1	2	3	1	3	14
OG0000569	4	1	1	1	1	4	2	14
OG0000570	5	1	4	3	0	1	0	14
OG0000571	6	2	2	2	1	0	1	14
OG0000572	3	2	2	2	0	5	0	14
OG0000573	2	1	2	1	5	1	2	14
OG0000574	1	3	1	1	3	3	2	14
OG0000575	7	1	1	1	1	2	1	14
OG0000576	4	2	2	2	1	2	1	14
OG0000577	5	1	1	1	2	1	3	14
OG0000578	14	0	0	0	0	0	0	14
OG0000579	2	1	1	1	2	1	6	14
OG0000580	2	1	1	1	4	1	4	14
OG0000581	14	0	0	0	0	0	0	14
OG0000582	5	2	2	2	1	1	1	14
OG0000583	7	2	2	2	0	1	0	14
OG0000584	4	1	2	1	2	1	3	14
OG0000585	2	1	1	1	1	1	7	14
OG0000586	4	3	1	3	1	1	1	14
OG0000587	4	1	1	1	2	2	3	14
OG0000588	3	2	2	2	1	1	3	14
OG0000589	7	1	1	1	2	1	1	14
OG0000590	5	1	1	1	2	2	2	14
OG0000591	8	1	3	2	0	0	0	14
OG0000592	4	1	1	1	2	1	4	14
OG0000593	4	1	1	1	2	1	4	14
OG0000594	4	1	1	1	1	3	3	14
OG0000595	4	1	1	2	2	2	2	14
OG0000596	7	1	1	1	1	1	2	14
OG0000597	4	2	2	2	0	4	0	14
OG0000598	7	1	1	1	2	1	1	14
OG0000599	4	0	3	3	2	0	2	14
OG0000600	4	2	2	3	1	1	1	14
OG0000601	4	2	2	3	1	0	2	14
OG0000602	3	2	2	2	2	2	1	14
OG0000603	7	2	3	2	0	0	0	14
OG0000604	5	1	1	1	3	1	2	14
OG0000605	3	4	1	5	0	1	0	14
OG0000606	6	1	1	1	1	1	3	14
OG0000607	4	1	1	1	1	1	5	14
OG0000608	2	2	1	2	0	7	0	14
OG0000609	3	4	2	2	0	3	0	14
OG0000610	4	2	2	3	0	3	0	14
OG0000611	4	1	2	1	3	0	3	14
OG0000612	2	2	1	2	0	3	4	14
OG0000613	4	2	1	2	1	1	3	14
OG0000614	14	0	0	0	0	0	0	14
OG0000615	6	2	2	1	1	1	1	14
OG0000616	4	1	1	1	2	1	4	14
OG0000617	5	2	2	1	1	1	2	14
OG0000618	13	0	1	0	0	0	0	14
OG0000619	6	1	1	1	2	1	2	14
OG0000620	4	2	1	1	2	2	2	14
OG0000621	5	1	0	1	2	1	4	14
OG0000622	4	1	1	1	3	2	2	14
OG0000623	4	2	2	2	1	1	2	14
OG0000624	4	3	2	1	1	2	1	14
OG0000625	10	1	1	1	0	1	0	14
OG0000626	5	1	4	1	1	1	1	14
OG0000627	4	1	1	2	1	0	5	14
OG0000628	2	3	4	3	0	2	0	14
OG0000629	8	2	0	3	0	0	1	14
OG0000630	3	2	2	2	1	3	1	14
OG0000631	2	2	2	3	1	2	2	14
OG0000632	3	1	1	1	3	2	3	14
OG0000633	2	1	1	2	4	1	3	14
OG0000634	1	1	1	1	6	2	2	14
OG0000635	2	1	1	1	1	2	6	14
OG0000636	2	1	1	5	2	1	2	14
OG0000637	4	3	2	3	0	1	1	14
OG0000638	4	2	2	2	1	2	1	14
OG0000639	2	1	1	3	1	3	3	14
OG0000640	2	2	2	1	4	1	2	14
OG0000641	5	2	1	2	1	2	1	14
OG0000642	2	1	1	1	1	2	6	14
OG0000643	7	1	1	2	0	2	1	14
OG0000644	2	1	2	1	1	1	6	14
OG0000645	3	1	2	3	3	1	1	14
OG0000646	1	1	1	1	4	1	5	14
OG0000647	4	1	1	1	3	1	3	14
OG0000648	2	1	6	1	1	1	2	14
OG0000649	2	1	2	1	1	1	6	14
OG0000650	4	1	1	1	3	1	3	14
OG0000651	2	1	1	4	3	1	2	14
OG0000652	4	3	3	2	0	2	0	14
OG0000653	0	5	7	2	0	0	0	14
OG0000654	0	14	0	0	0	0	0	14
OG0000655	0	8	2	4	0	0	0	14
OG0000656	0	1	0	13	0	0	0	14
OG0000657	0	0	14	0	0	0	0	14
OG0000658	0	0	11	3	0	0	0	14
OG0000659	0	0	14	0	0	0	0	14
OG0000660	0	0	14	0	0	0	0	14
OG0000661	0	0	3	6	0	5	0	14
OG0000662	0	0	14	0	0	0	0	14
OG0000663	0	0	2	12	0	0	0	14
OG0000664	0	0	0	14	0	0	0	14
OG0000665	0	0	0	0	12	0	2	14
OG0000666	0	0	0	0	3	0	11	14
OG0000667	0	0	0	0	0	14	0	14
OG0000668	0	0	0	0	0	14	0	14
OG0000669	0	0	0	0	0	14	0	14
OG0000670	0	0	0	0	0	0	14	14
OG0000671	0	0	0	0	0	0	14	14
OG0000672	0	0	0	0	0	0	14	14
OG0000673	0	0	0	0	0	0	14	14
OG0000674	0	0	0	0	0	0	14	14
OG0000675	0	0	0	0	0	0	14	14
OG0000676	0	0	0	0	0	0	14	14
OG0000677	0	0	0	0	0	0	14	14
OG0000678	0	0	0	0	0	0	14	14
OG0000679	4	1	5	1	1	1	0	13
OG0000680	3	1	2	2	1	2	2	13
OG0000681	4	1	1	2	3	1	1	13
OG0000682	3	1	1	1	2	1	4	13
OG0000683	4	3	1	2	1	1	1	13
OG0000684	2	1	1	4	1	1	3	13
OG0000685	5	2	4	2	0	0	0	13
OG0000686	2	1	1	1	1	3	4	13
OG0000687	3	2	2	1	2	2	1	13
OG0000688	8	0	1	0	0	4	0	13
OG0000689	6	2	2	2	0	1	0	13
OG0000690	2	1	1	2	2	1	4	13
OG0000691	3	1	1	2	2	1	3	13
OG0000692	2	2	2	2	1	2	2	13
OG0000693	2	1	1	1	1	1	6	13
OG0000694	2	2	5	1	1	1	1	13
OG0000695	2	1	1	1	2	1	5	13
OG0000696	3	1	1	1	4	1	2	13
OG0000697	5	2	1	1	1	1	2	13
OG0000698	2	1	6	1	1	1	1	13
OG0000699	4	2	1	2	3	0	1	13
OG0000700	4	1	1	1	2	1	3	13
OG0000701	7	1	1	1	2	1	0	13
OG0000702	13	0	0	0	0	0	0	13
OG0000703	6	2	2	2	0	0	1	13
OG0000704	5	1	1	1	2	2	1	13
OG0000705	5	2	1	2	1	1	1	13
OG0000706	5	1	1	1	2	1	2	13
OG0000707	5	3	2	1	0	2	0	13
OG0000708	5	2	2	1	1	1	1	13
OG0000709	3	3	1	5	0	1	0	13
OG0000710	13	0	0	0	0	0	0	13
OG0000711	2	4	1	1	1	1	3	13
OG0000712	6	2	2	2	0	1	0	13
OG0000713	5	1	1	1	1	1	3	13
OG0000714	5	1	1	1	3	0	2	13
OG0000715	4	1	1	1	4	1	1	13
OG0000716	5	1	1	1	1	2	2	13
OG0000717	2	2	2	2	2	1	2	13
OG0000718	4	1	1	2	3	1	1	13
OG0000719	4	2	3	1	2	0	1	13
OG0000720	2	1	1	1	3	1	4	13
OG0000721	3	1	1	3	1	3	1	13
OG0000722	7	1	1	1	1	1	1	13
OG0000723	2	1	1	1	2	0	6	13
OG0000724	6	1	1	3	0	1	1	13
OG0000725	7	2	2	1	0	1	0	13
OG0000726	5	1	1	1	3	1	1	13
OG0000727	4	1	1	1	2	1	3	13
OG0000728	4	2	2	2	1	1	1	13
OG0000729	4	1	1	1	2	1	3	13
OG0000730	2	2	2	2	1	2	2	13
OG0000731	2	1	1	2	4	1	2	13
OG0000732	5	1	1	1	2	1	2	13
OG0000733	5	1	2	1	2	1	1	13
OG0000734	3	1	1	2	3	1	2	13
OG0000735	3	1	1	1	1	1	5	13
OG0000736	4	3	1	2	1	1	1	13
OG0000737	2	1	1	1	4	1	3	13
OG0000738	2	1	1	2	4	1	2	13
OG0000739	2	1	1	2	2	1	4	13
OG0000740	3	1	1	4	2	1	1	13
OG0000741	5	0	3	5	0	0	0	13
OG0000742	3	1	1	2	2	1	3	13
OG0000743	2	1	1	1	2	1	5	13
OG0000744	2	3	3	2	0	3	0	13
OG0000745	2	1	1	2	2	1	4	13
OG0000746	5	1	1	1	2	1	2	13
OG0000747	3	1	4	1	1	2	1	13
OG0000748	2	1	3	3	1	1	2	13
OG0000749	4	2	1	1	2	2	1	13
OG0000750	13	0	0	0	0	0	0	13
OG0000751	5	1	1	1	2	1	2	13
OG0000752	2	1	0	1	4	2	3	13
OG0000753	3	1	1	1	3	2	2	13
OG0000754	3	1	1	1	1	1	5	13
OG0000755	4	1	1	1	2	1	3	13
OG0000756	2	2	4	1	1	1	2	13
OG0000757	4	2	3	3	0	1	0	13
OG0000758	6	1	1	1	2	1	1	13
OG0000759	6	1	1	1	1	1	2	13
OG0000760	2	2	1	2	3	1	2	13
OG0000761	2	2	1	2	1	1	4	13
OG0000762	2	1	2	1	1	1	5	13
OG0000763	5	1	1	1	1	2	2	13
OG0000764	2	1	0	1	6	1	2	13
OG0000765	4	2	2	3	0	2	0	13
OG0000766	2	1	2	1	1	2	4	13
OG0000767	2	1	1	1	4	1	3	13
OG0000768	4	1	1	1	2	1	3	13
OG0000769	3	2	1	2	1	2	2	13
OG0000770	6	2	2	3	0	0	0	13
OG0000771	3	1	1	1	1	3	3	13
OG0000772	2	1	1	1	1	2	5	13
OG0000773	3	2	2	6	0	0	0	13
OG0000774	3	1	1	2	1	2	3	13
OG0000775	5	1	2	2	1	1	1	13
OG0000776	6	1	1	1	1	1	2	13
OG0000777	2	1	1	1	1	1	6	13
OG0000778	5	0	2	1	1	1	3	13
OG0000779	3	2	1	1	1	1	4	13
OG0000780	2	1	1	1	3	4	1	13
OG0000781	2	1	1	1	1	3	4	13
OG0000782	3	4	2	1	0	3	0	13
OG0000783	2	0	0	0	4	1	6	13
OG0000784	0	13	0	0	0	0	0	13
OG0000785	0	8	2	3	0	0	0	13
OG0000786	0	5	2	6	0	0	0	13
OG0000787	0	13	0	0	0	0	0	13
OG0000788	0	1	1	5	1	2	3	13
OG0000789	0	1	1	1	2	0	8	13
OG0000790	0	1	0	2	3	0	7	13
OG0000791	0	4	3	6	0	0	0	13
OG0000792	0	1	2	2	1	3	4	13
OG0000793	0	1	4	8	0	0	0	13
OG0000794	0	0	13	0	0	0	0	13
OG0000795	0	0	13	0	0	0	0	13
OG0000796	0	0	13	0	0	0	0	13
OG0000797	0	0	1	12	0	0	0	13
OG0000798	0	0	13	0	0	0	0	13
OG0000799	0	0	12	1	0	0	0	13
OG0000800	0	0	13	0	0	0	0	13
OG0000801	0	0	13	0	0	0	0	13
OG0000802	0	0	13	0	0	0	0	13
OG0000803	0	0	13	0	0	0	0	13
OG0000804	0	0	10	3	0	0	0	13
OG0000805	0	0	13	0	0	0	0	13
OG0000806	0	0	0	0	13	0	0	13
OG0000807	0	0	0	0	11	0	2	13
OG0000808	0	0	0	0	5	2	6	13
OG0000809	0	0	0	0	1	0	12	13
OG0000810	0	0	0	0	1	0	12	13
OG0000811	0	0	0	0	2	0	11	13
OG0000812	0	0	0	0	1	12	0	13
OG0000813	0	0	0	0	2	2	9	13
OG0000814	0	0	0	0	1	1	11	13
OG0000815	0	0	0	0	0	13	0	13
OG0000816	0	0	0	0	0	0	13	13
OG0000817	0	0	0	0	0	0	13	13
OG0000818	0	0	0	0	0	0	13	13
OG0000819	0	0	0	0	0	0	13	13
OG0000820	0	0	0	0	0	0	13	13
OG0000821	0	0	0	0	0	0	13	13
OG0000822	0	0	0	0	0	0	13	13
OG0000823	0	0	0	0	0	0	13	13
OG0000824	0	0	0	0	0	0	13	13
OG0000825	0	0	0	0	0	0	13	13
OG0000826	0	0	0	0	0	0	13	13
OG0000827	0	0	0	0	0	0	13	13
OG0000828	0	0	0	0	0	0	13	13
OG0000829	0	0	0	0	0	0	13	13
OG0000830	4	1	1	2	1	2	1	12
OG0000831	4	1	2	0	1	1	3	12
OG0000832	4	3	1	1	1	0	2	12
OG0000833	4	1	1	1	2	1	2	12
OG0000834	9	0	1	1	0	1	0	12
OG0000835	2	1	1	1	3	1	3	12
OG0000836	2	1	1	1	3	1	3	12
OG0000837	2	1	1	1	3	1	3	12
OG0000838	3	1	1	2	3	1	1	12
OG0000839	4	1	1	1	3	1	1	12
OG0000840	3	1	2	1	1	1	3	12
OG0000841	4	2	1	1	1	2	1	12
OG0000842	6	1	1	1	1	1	1	12
OG0000843	3	1	1	1	1	2	3	12
OG0000844	3	1	1	1	4	1	1	12
OG0000845	2	1	1	1	3	2	2	12
OG0000846	2	1	1	1	1	2	4	12
OG0000847	6	1	1	1	1	1	1	12
OG0000848	2	1	1	2	2	1	3	12
OG0000849	2	1	1	1	1	3	3	12
OG0000850	2	1	1	2	4	1	1	12
OG0000851	2	2	2	2	1	2	1	12
OG0000852	2	1	1	1	4	2	1	12
OG0000853	3	1	1	2	2	1	2	12
OG0000854	3	1	1	1	1	1	4	12
OG0000855	1	2	1	2	1	1	4	12
OG0000856	4	1	1	2	1	1	2	12
OG0000857	4	1	1	1	1	2	2	12
OG0000858	2	0	2	1	1	2	4	12
OG0000859	2	1	1	2	1	2	3	12
OG0000860	5	2	1	2	0	1	1	12
OG0000861	3	1	1	1	2	3	1	12
OG0000862	4	1	2	2	1	1	1	12
OG0000863	3	4	1	1	1	1	1	12
OG0000864	4	1	2	1	2	1	1	12
OG0000865	4	1	1	1	1	0	4	12
OG0000866	6	1	1	1	1	1	1	12
OG0000867	3	1	1	1	2	1	3	12
OG0000868	6	1	1	1	1	1	1	12
OG0000869	5	1	1	2	1	1	1	12
OG0000870	2	1	2	1	2	2	2	12
OG0000871	12	0	0	0	0	0	0	12
OG0000872	4	2	1	1	1	1	2	12
OG0000873	3	1	1	2	1	1	3	12
OG0000874	2	1	1	1	1	1	5	12
OG0000875	8	1	1	1	0	1	0	12
OG0000876	2	4	1	2	0	3	0	12
OG0000877	5	1	1	1	1	1	2	12
OG0000878	3	1	1	1	3	2	1	12
OG0000879	3	1	2	1	1	1	3	12
OG0000880	4	1	0	2	1	2	2	12
OG0000881	2	1	1	1	1	1	5	12
OG0000882	4	1	1	1	0	2	3	12
OG0000883	2	1	1	1	1	2	4	12
OG0000884	3	1	4	1	1	1	1	12
OG0000885	2	1	1	1	1	1	5	12
OG0000886	3	1	2	1	2	2	1	12
OG0000887	3	1	1	1	3	1	2	12
OG0000888	2	1	1	4	2	1	1	12
OG0000889	1	1	2	1	2	1	4	12
OG0000890	4	1	1	2	1	2	1	12
OG0000891	2	1	1	2	2	1	3	12
OG0000892	5	2	1	1	1	0	2	12
OG0000893	5	1	1	1	1	1	2	12
OG0000894	5	1	1	1	2	1	1	12
OG0000895	3	2	1	3	1	1	1	12
OG0000896	5	1	1	2	1	1	1	12
OG0000897	3	1	1	1	1	1	4	12
OG0000898	5	1	1	1	2	1	1	12
OG0000899	2	1	1	1	1	2	4	12
OG0000900	2	1	1	1	4	1	2	12
OG0000901	5	1	1	1	1	2	1	12
OG0000902	4	1	2	2	0	2	1	12
OG0000903	2	1	1	1	2	1	4	12
OG0000904	3	2	1	1	2	1	2	12
OG0000905	4	1	1	1	1	1	3	12
OG0000906	4	1	1	2	2	1	1	12
OG0000907	5	2	1	2	0	1	1	12
OG0000908	4	1	1	1	1	1	3	12
OG0000909	2	1	1	1	3	1	3	12
OG0000910	3	1	1	1	3	1	2	12
OG0000911	5	1	2	1	1	1	1	12
OG0000912	2	1	1	1	2	1	4	12
OG0000913	5	1	1	1	1	1	2	12
OG0000914	2	3	1	2	2	1	1	12
OG0000915	2	1	1	1	2	2	3	12
OG0000916	2	1	1	1	3	1	3	12
OG0000917	12	0	0	0	0	0	0	12
OG0000918	3	1	1	1	1	1	4	12
OG0000919	2	1	1	1	2	2	3	12
OG0000920	3	0	3	6	0	0	0	12
OG0000921	4	1	1	1	1	2	2	12
OG0000922	4	1	1	1	1	1	3	12
OG0000923	3	1	1	3	2	1	1	12
OG0000924	2	1	1	2	2	1	3	12
OG0000925	3	1	1	0	1	1	5	12
OG0000926	2	1	1	1	3	1	3	12
OG0000927	5	2	1	1	1	1	1	12
OG0000928	1	1	1	2	3	2	2	12
OG0000929	2	1	1	1	3	2	2	12
OG0000930	4	1	1	2	1	1	2	12
OG0000931	4	1	1	2	1	1	2	12
OG0000932	2	1	1	2	2	2	2	12
OG0000933	3	1	3	1	2	1	1	12
OG0000934	2	1	1	2	1	1	4	12
OG0000935	2	1	1	2	2	1	3	12
OG0000936	2	4	1	2	2	0	1	12
OG0000937	4	1	1	1	2	1	2	12
OG0000938	2	1	1	1	2	1	4	12
OG0000939	2	1	1	1	3	1	3	12
OG0000940	2	1	2	2	2	2	1	12
OG0000941	3	1	1	1	2	1	3	12
OG0000942	2	1	1	1	2	1	4	12
OG0000943	3	1	1	1	2	3	1	12
OG0000944	2	1	1	1	4	1	2	12
OG0000945	2	1	1	1	3	2	2	12
OG0000946	12	0	0	0	0	0	0	12
OG0000947	6	1	0	1	1	1	2	12
OG0000948	5	1	1	2	1	1	1	12
OG0000949	5	2	1	1	1	1	1	12
OG0000950	3	1	1	0	1	1	5	12
OG0000951	2	2	1	2	1	2	2	12
OG0000952	2	1	1	1	3	1	3	12
OG0000953	2	2	1	1	4	1	1	12
OG0000954	2	1	1	1	2	1	4	12
OG0000955	2	1	1	1	3	1	3	12
OG0000956	2	1	1	1	2	1	4	12
OG0000957	4	1	1	1	2	1	2	12
OG0000958	4	1	1	1	2	2	1	12
OG0000959	4	1	1	2	1	2	1	12
OG0000960	3	1	1	3	2	1	1	12
OG0000961	5	1	1	1	1	1	2	12
OG0000962	2	3	3	3	0	1	0	12
OG0000963	2	3	1	2	2	1	1	12
OG0000964	3	1	1	2	1	2	2	12
OG0000965	8	0	2	1	0	0	1	12
OG0000966	3	1	1	1	4	1	1	12
OG0000967	3	1	2	1	2	1	2	12
OG0000968	2	2	1	2	2	2	1	12
OG0000969	2	1	1	2	2	1	3	12
OG0000970	5	1	1	1	2	1	1	12
OG0000971	4	0	1	1	4	0	2	12
OG0000972	3	1	1	1	4	0	2	12
OG0000973	5	1	1	1	1	1	2	12
OG0000974	4	2	2	1	1	1	1	12
OG0000975	2	1	1	1	3	1	3	12
OG0000976	2	3	1	1	2	1	2	12
OG0000977	4	1	1	2	2	1	1	12
OG0000978	4	1	1	1	2	1	2	12
OG0000979	2	1	1	1	3	2	2	12
OG0000980	1	2	2	2	2	1	2	12
OG0000981	2	1	6	1	0	1	1	12
OG0000982	2	2	1	1	1	1	4	12
OG0000983	3	2	1	1	2	1	2	12
OG0000984	3	2	4	2	0	1	0	12
OG0000985	3	1	1	1	3	1	2	12
OG0000986	12	0	0	0	0	0	0	12
OG0000987	2	2	1	2	2	2	1	12
OG0000988	3	1	1	1	2	1	3	12
OG0000989	2	1	1	5	1	1	1	12
OG0000990	2	1	1	1	3	1	3	12
OG0000991	2	1	1	1	2	1	4	12
OG0000992	2	1	1	1	2	2	3	12
OG0000993	5	1	2	3	0	1	0	12
OG0000994	1	1	1	2	3	1	3	12
OG0000995	2	1	1	1	3	2	2	12
OG0000996	2	1	2	1	2	0	4	12
OG0000997	3	1	1	2	1	2	2	12
OG0000998	2	1	1	2	2	1	3	12
OG0000999	4	2	1	2	1	1	1	12
OG0001000	2	1	1	1	2	1	4	12
OG0001001	2	1	1	1	1	3	3	12
OG0001002	7	2	2	1	0	0	0	12
OG0001003	2	1	1	5	1	1	1	12
OG0001004	4	1	1	1	2	1	2	12
OG0001005	2	1	1	1	2	2	3	12
OG0001006	4	1	1	1	2	1	2	12
OG0001007	2	1	2	2	1	2	2	12
OG0001008	2	1	1	1	2	1	4	12
OG0001009	2	1	1	1	2	2	3	12
OG0001010	3	1	1	1	1	1	4	12
OG0001011	2	1	2	4	1	1	1	12
OG0001012	2	1	1	1	4	2	1	12
OG0001013	0	1	1	1	2	1	6	12
OG0001014	0	12	0	0	0	0	0	12
OG0001015	0	12	0	0	0	0	0	12
OG0001016	0	2	1	2	5	2	0	12
OG0001017	0	0	12	0	0	0	0	12
OG0001018	0	0	12	0	0	0	0	12
OG0001019	0	0	0	11	0	0	1	12
OG0001020	0	0	0	12	0	0	0	12
OG0001021	0	0	0	12	0	0	0	12
OG0001022	0	0	0	12	0	0	0	12
OG0001023	0	0	0	0	10	0	2	12
OG0001024	0	0	0	0	4	0	8	12
OG0001025	0	0	0	0	1	0	11	12
OG0001026	0	0	0	0	1	0	11	12
OG0001027	0	0	0	0	0	12	0	12
OG0001028	0	0	0	0	0	12	0	12
OG0001029	0	0	0	0	0	1	11	12
OG0001030	0	0	0	0	0	0	12	12
OG0001031	0	0	0	0	0	0	12	12
OG0001032	0	0	0	0	0	0	12	12
OG0001033	0	0	0	0	0	0	12	12
OG0001034	0	0	0	0	0	0	12	12
OG0001035	0	0	0	0	0	0	12	12
OG0001036	0	0	0	0	0	0	12	12
OG0001037	0	0	0	0	0	0	12	12
OG0001038	0	0	0	0	0	0	12	12
OG0001039	0	0	0	0	0	0	12	12
OG0001040	0	0	0	0	0	0	12	12
OG0001041	2	1	1	1	3	1	2	11
OG0001042	2	1	1	1	3	1	2	11
OG0001043	2	1	1	2	2	1	2	11
OG0001044	4	2	1	1	1	1	1	11
OG0001045	5	1	1	1	1	1	1	11
OG0001046	2	1	1	2	1	1	3	11
OG0001047	4	1	1	2	1	1	1	11
OG0001048	2	1	2	2	1	1	2	11
OG0001049	11	0	0	0	0	0	0	11
OG0001050	2	2	1	1	2	1	2	11
OG0001051	2	2	2	1	0	2	2	11
OG0001052	2	1	1	1	1	2	3	11
OG0001053	2	1	1	1	2	1	3	11
OG0001054	3	0	0	0	2	1	5	11
OG0001055	2	1	1	1	1	1	4	11
OG0001056	4	1	1	1	1	2	1	11
OG0001057	4	1	1	2	1	1	1	11
OG0001058	4	1	2	1	1	1	1	11
OG0001059	1	4	1	1	1	0	3	11
OG0001060	2	1	1	1	2	1	3	11
OG0001061	2	1	1	1	2	1	3	11
OG0001062	2	2	1	1	2	1	2	11
OG0001063	5	1	1	1	1	1	1	11
OG0001064	2	3	1	1	1	2	1	11
OG0001065	5	2	2	1	0	1	0	11
OG0001066	2	2	1	1	3	1	1	11
OG0001067	3	1	2	1	1	2	1	11
OG0001068	2	1	1	1	3	1	2	11
OG0001069	2	1	1	1	1	2	3	11
OG0001070	2	1	1	1	1	2	3	11
OG0001071	2	1	1	1	1	2	3	11
OG0001072	3	1	1	1	2	2	1	11
OG0001073	2	1	1	1	3	1	2	11
OG0001074	2	1	1	1	1	1	4	11
OG0001075	3	1	1	1	1	2	2	11
OG0001076	2	1	1	1	1	1	4	11
OG0001077	4	2	1	1	0	3	0	11
OG0001078	4	1	1	1	1	2	1	11
OG0001079	5	1	1	1	1	1	1	11
OG0001080	6	1	1	1	1	1	0	11
OG0001081	4	1	1	1	2	1	1	11
OG0001082	3	1	1	2	2	1	1	11
OG0001083	2	1	1	1	1	1	4	11
OG0001084	3	1	1	3	1	1	1	11
OG0001085	3	2	2	2	1	1	0	11
OG0001086	3	1	1	1	1	1	3	11
OG0001087	2	1	1	1	1	2	3	11
OG0001088	3	1	1	1	1	1	3	11
OG0001089	2	1	1	1	1	1	4	11
OG0001090	1	1	1	1	4	0	3	11
OG0001091	2	1	1	1	3	1	2	11
OG0001092	2	1	1	1	1	2	3	11
OG0001093	4	1	1	1	2	1	1	11
OG0001094	2	1	1	2	1	1	3	11
OG0001095	4	1	1	2	1	1	1	11
OG0001096	3	1	1	1	1	1	3	11
OG0001097	3	1	1	1	1	1	3	11
OG0001098	2	1	1	1	2	2	2	11
OG0001099	2	2	2	1	2	1	1	11
OG0001100	7	1	2	1	0	0	0	11
OG0001101	4	1	1	1	1	2	1	11
OG0001102	11	0	0	0	0	0	0	11
OG0001103	2	1	1	1	3	1	2	11
OG0001104	2	2	1	1	1	2	2	11
OG0001105	4	1	1	1	2	1	1	11
OG0001106	5	2	1	1	0	2	0	11
OG0001107	2	1	2	2	1	2	1	11
OG0001108	4	1	1	1	1	1	2	11
OG0001109	2	1	1	0	3	0	4	11
OG0001110	3	1	1	1	1	2	2	11
OG0001111	3	1	1	1	1	2	2	11
OG0001112	1	1	1	2	2	2	2	11
OG0001113	5	1	1	0	1	1	2	11
OG0001114	2	1	1	1	2	2	2	11
OG0001115	4	1	1	1	1	1	2	11
OG0001116	5	1	1	1	1	1	1	11
OG0001117	5	1	1	1	1	1	1	11
OG0001118	2	1	1	1	2	1	3	11
OG0001119	2	1	0	2	1	1	4	11
OG0001120	2	1	1	1	3	1	2	11
OG0001121	4	1	1	1	1	1	2	11
OG0001122	4	1	1	1	2	1	1	11
OG0001123	2	1	1	2	2	2	1	11
OG0001124	1	2	1	3	2	1	1	11
OG0001125	2	1	1	1	2	3	1	11
OG0001126	2	2	1	1	1	2	2	11
OG0001127	2	1	1	2	2	1	2	11
OG0001128	4	1	1	1	1	1	2	11
OG0001129	4	1	1	1	2	1	1	11
OG0001130	2	1	1	1	3	1	2	11
OG0001131	2	3	1	2	1	1	1	11
OG0001132	2	1	1	1	2	2	2	11
OG0001133	5	1	1	1	1	1	1	11
OG0001134	2	1	1	1	1	1	4	11
OG0001135	3	1	1	1	2	1	2	11
OG0001136	4	1	2	1	0	3	0	11
OG0001137	2	2	1	2	2	1	1	11
OG0001138	3	1	1	1	2	2	1	11
OG0001139	5	1	1	1	1	1	1	11
OG0001140	4	1	1	1	1	2	1	11
OG0001141	3	2	1	1	1	2	1	11
OG0001142	4	1	1	1	1	1	2	11
OG0001143	2	1	1	2	1	1	3	11
OG0001144	4	1	1	2	1	1	1	11
OG0001145	3	1	1	1	1	1	3	11
OG0001146	3	1	1	1	1	1	3	11
OG0001147	2	1	1	2	1	2	2	11
OG0001148	3	1	1	2	1	1	2	11
OG0001149	2	1	1	1	1	1	4	11
OG0001150	2	1	1	1	3	1	2	11
OG0001151	2	1	1	2	1	1	3	11
OG0001152	4	1	1	2	1	1	1	11
OG0001153	4	2	2	2	0	1	0	11
OG0001154	3	1	1	1	3	1	1	11
OG0001155	6	1	1	2	0	1	0	11
OG0001156	4	2	2	2	0	1	0	11
OG0001157	4	1	1	1	2	1	1	11
OG0001158	2	1	1	1	2	1	3	11
OG0001159	3	1	1	1	1	1	3	11
OG0001160	2	1	1	1	1	1	4	11
OG0001161	3	1	1	3	0	1	2	11
OG0001162	6	1	1	0	1	1	1	11
OG0001163	3	1	1	1	1	1	3	11
OG0001164	4	1	1	2	1	1	1	11
OG0001165	4	1	1	1	2	1	1	11
OG0001166	2	1	1	1	1	1	4	11
OG0001167	5	1	1	1	1	1	1	11
OG0001168	4	1	1	2	1	1	1	11
OG0001169	2	1	1	2	2	0	3	11
OG0001170	2	1	1	1	2	1	3	11
OG0001171	2	1	1	1	4	1	1	11
OG0001172	2	1	1	1	3	1	2	11
OG0001173	3	1	1	2	1	0	3	11
OG0001174	5	1	1	1	2	0	1	11
OG0001175	4	1	1	1	1	2	1	11
OG0001176	2	2	1	3	1	1	1	11
OG0001177	2	2	1	2	2	1	1	11
OG0001178	3	1	1	1	2	1	2	11
OG0001179	4	2	1	1	1	1	1	11
OG0001180	1	1	1	1	2	1	4	11
OG0001181	2	1	1	1	3	1	2	11
OG0001182	4	1	1	1	2	1	1	11
OG0001183	2	1	1	2	1	1	3	11
OG0001184	5	1	1	1	1	1	1	11
OG0001185	2	2	1	1	1	1	3	11
OG0001186	2	1	1	2	1	1	3	11
OG0001187	4	1	1	2	1	1	1	11
OG0001188	3	1	1	2	1	2	1	11
OG0001189	2	1	1	1	2	1	3	11
OG0001190	2	2	1	1	3	1	1	11
OG0001191	3	1	2	1	2	1	1	11
OG0001192	5	1	1	1	2	0	1	11
OG0001193	4	1	1	1	1	2	1	11
OG0001194	1	1	1	1	2	1	4	11
OG0001195	2	1	1	2	2	1	2	11
OG0001196	2	0	3	1	2	1	2	11
OG0001197	2	1	1	1	1	4	1	11
OG0001198	4	1	1	1	2	1	1	11
OG0001199	2	1	1	1	2	1	3	11
OG0001200	2	1	1	1	1	4	1	11
OG0001201	2	1	1	1	1	1	4	11
OG0001202	2	1	2	1	2	2	1	11
OG0001203	2	2	1	1	2	2	1	11
OG0001204	2	1	1	1	1	1	4	11
OG0001205	3	1	1	1	2	1	2	11
OG0001206	2	1	1	0	2	1	4	11
OG0001207	3	2	1	1	1	1	2	11
OG0001208	2	1	1	2	1	1	3	11
OG0001209	2	1	1	1	3	1	2	11
OG0001210	3	1	1	2	1	1	2	11
OG0001211	2	1	1	1	1	3	2	11
OG0001212	2	2	1	1	1	1	3	11
OG0001213	4	0	0	0	0	2	5	11
OG0001214	5	1	1	1	1	1	1	11
OG0001215	2	1	1	1	2	1	3	11
OG0001216	2	1	1	1	3	1	2	11
OG0001217	5	1	1	1	1	1	1	11
OG0001218	3	1	1	2	1	2	1	11
OG0001219	2	1	1	2	2	2	1	11
OG0001220	4	2	2	2	0	1	0	11
OG0001221	2	2	1	1	2	1	2	11
OG0001222	4	1	1	1	2	1	1	11
OG0001223	3	1	1	1	1	1	3	11
OG0001224	3	1	1	1	2	1	2	11
OG0001225	4	1	1	1	2	1	1	11
OG0001226	2	1	1	1	3	1	2	11
OG0001227	4	1	1	1	2	1	1	11
OG0001228	5	1	1	1	1	2	0	11
OG0001229	5	1	1	1	1	1	1	11
OG0001230	2	1	1	1	2	0	4	11
OG0001231	3	1	1	1	2	1	2	11
OG0001232	3	1	1	1	3	1	1	11
OG0001233	2	2	1	1	3	1	1	11
OG0001234	3	1	1	1	1	2	2	11
OG0001235	6	1	2	2	0	0	0	11
OG0001236	4	1	1	1	1	1	2	11
OG0001237	5	1	1	1	1	1	1	11
OG0001238	2	2	1	1	3	1	1	11
OG0001239	2	1	1	1	2	1	3	11
OG0001240	2	1	1	1	2	1	3	11
OG0001241	2	1	1	2	1	1	3	11
OG0001242	2	1	3	1	1	1	2	11
OG0001243	3	1	1	1	1	1	3	11
OG0001244	2	1	1	1	2	2	2	11
OG0001245	2	1	1	1	2	1	3	11
OG0001246	2	1	1	1	3	1	2	11
OG0001247	3	1	1	1	1	2	2	11
OG0001248	2	1	4	2	0	2	0	11
OG0001249	2	1	1	1	2	1	3	11
OG0001250	2	1	2	1	1	1	3	11
OG0001251	2	2	1	0	2	1	3	11
OG0001252	5	1	1	1	1	1	1	11
OG0001253	4	1	1	1	2	1	1	11
OG0001254	2	1	2	2	2	1	1	11
OG0001255	3	2	3	2	0	1	0	11
OG0001256	3	1	1	1	1	3	1	11
OG0001257	3	1	1	1	1	1	3	11
OG0001258	2	1	2	1	0	2	3	11
OG0001259	3	1	1	1	1	1	3	11
OG0001260	3	2	2	3	0	1	0	11
OG0001261	3	1	1	1	3	1	1	11
OG0001262	2	2	1	1	3	1	1	11
OG0001263	3	1	1	2	1	1	2	11
OG0001264	4	1	1	1	1	2	1	11
OG0001265	3	1	1	1	1	1	3	11
OG0001266	2	1	1	0	4	1	2	11
OG0001267	2	1	1	1	3	1	2	11
OG0001268	3	2	1	0	2	1	2	11
OG0001269	3	1	1	3	1	1	1	11
OG0001270	2	1	1	1	2	1	3	11
OG0001271	5	0	0	0	2	1	3	11
OG0001272	2	1	3	1	2	1	1	11
OG0001273	2	3	1	1	1	1	2	11
OG0001274	3	1	1	1	2	1	2	11
OG0001275	2	1	1	2	2	1	2	11
OG0001276	2	1	1	2	3	1	1	11
OG0001277	2	1	1	2	1	1	3	11
OG0001278	2	1	2	1	1	1	3	11
OG0001279	2	1	1	3	2	1	1	11
OG0001280	4	1	1	1	2	1	1	11
OG0001281	2	1	1	1	2	1	3	11
OG0001282	2	1	1	2	3	1	1	11
OG0001283	8	0	1	2	0	0	0	11
OG0001284	4	2	1	4	0	0	0	11
OG0001285	2	1	1	1	1	1	4	11
OG0001286	2	1	1	1	2	1	3	11
OG0001287	4	1	1	1	1	1	2	11
OG0001288	2	1	1	2	3	1	1	11
OG0001289	2	1	1	1	2	1	3	11
OG0001290	2	1	1	1	3	1	2	11
OG0001291	2	1	1	1	2	2	2	11
OG0001292	3	1	1	1	1	1	3	11
OG0001293	3	1	1	1	1	1	3	11
OG0001294	2	1	1	2	2	1	2	11
OG0001295	2	2	1	3	1	1	1	11
OG0001296	2	1	1	1	1	1	4	11
OG0001297	2	1	1	1	2	1	3	11
OG0001298	2	1	1	1	3	1	2	11
OG0001299	3	1	1	1	1	1	3	11
OG0001300	4	1	1	2	0	3	0	11
OG0001301	2	2	1	1	1	0	4	11
OG0001302	2	1	1	1	2	1	3	11
OG0001303	1	1	1	1	1	1	5	11
OG0001304	4	1	1	1	1	1	2	11
OG0001305	2	2	1	1	1	2	2	11
OG0001306	3	1	1	1	1	1	3	11
OG0001307	3	1	1	1	2	1	2	11
OG0001308	4	1	1	1	2	1	1	11
OG0001309	2	1	1	1	2	1	3	11
OG0001310	2	2	1	1	1	1	3	11
OG0001311	5	1	2	1	1	1	0	11
OG0001312	6	1	0	1	1	1	1	11
OG0001313	2	1	1	2	1	2	2	11
OG0001314	2	1	1	2	1	1	3	11
OG0001315	2	1	1	1	1	1	4	11
OG0001316	3	1	1	3	1	1	1	11
OG0001317	2	1	1	2	1	1	3	11
OG0001318	1	1	1	1	4	1	2	11
OG0001319	2	1	1	1	3	1	2	11
OG0001320	4	1	1	1	1	2	1	11
OG0001321	2	1	1	1	1	1	4	11
OG0001322	1	2	2	1	3	1	1	11
OG0001323	1	2	1	2	3	1	1	11
OG0001324	1	1	1	1	1	1	5	11
OG0001325	4	1	2	1	1	1	1	11
OG0001326	2	1	1	2	3	1	1	11
OG0001327	2	1	1	2	0	3	2	11
OG0001328	2	1	1	1	1	3	2	11
OG0001329	3	2	1	2	1	1	1	11
OG0001330	2	1	1	1	1	2	3	11
OG0001331	4	1	1	2	1	1	1	11
OG0001332	6	0	1	2	1	1	0	11
OG0001333	5	1	1	1	1	1	1	11
OG0001334	2	1	1	2	2	1	2	11
OG0001335	2	1	1	1	1	1	4	11
OG0001336	3	1	1	1	2	2	1	11
OG0001337	2	1	1	1	3	1	2	11
OG0001338	2	2	1	1	2	2	1	11
OG0001339	2	1	1	4	1	1	1	11
OG0001340	11	0	0	0	0	0	0	11
OG0001341	2	1	1	1	2	1	3	11
OG0001342	2	1	1	1	3	1	2	11
OG0001343	2	1	2	1	1	1	3	11
OG0001344	2	1	1	4	1	1	1	11
OG0001345	4	1	1	1	2	1	1	11
OG0001346	2	1	1	2	1	2	2	11
OG0001347	2	2	1	3	1	1	1	11
OG0001348	1	1	1	1	3	1	3	11
OG0001349	1	1	1	1	2	1	4	11
OG0001350	0	11	0	0	0	0	0	11
OG0001351	0	11	0	0	0	0	0	11
OG0001352	0	6	1	3	0	1	0	11
OG0001353	0	2	2	2	1	1	3	11
OG0001354	0	10	0	1	0	0	0	11
OG0001355	0	5	3	3	0	0	0	11
OG0001356	0	7	1	2	0	1	0	11
OG0001357	0	11	0	0	0	0	0	11
OG0001358	0	3	3	5	0	0	0	11
OG0001359	0	1	1	1	2	2	4	11
OG0001360	0	0	11	0	0	0	0	11
OG0001361	0	0	1	0	0	0	10	11
OG0001362	0	0	11	0	0	0	0	11
OG0001363	0	0	11	0	0	0	0	11
OG0001364	0	0	11	0	0	0	0	11
OG0001365	0	0	1	1	0	9	0	11
OG0001366	0	0	0	11	0	0	0	11
OG0001367	0	0	0	11	0	0	0	11
OG0001368	0	0	0	11	0	0	0	11
OG0001369	0	0	0	0	11	0	0	11
OG0001370	0	0	0	0	11	0	0	11
OG0001371	0	0	0	0	9	0	2	11
OG0001372	0	0	0	0	5	0	6	11
OG0001373	0	0	0	0	5	0	6	11
OG0001374	0	0	0	0	6	1	4	11
OG0001375	0	0	0	0	5	0	6	11
OG0001376	0	0	0	0	1	0	10	11
OG0001377	0	0	0	0	7	3	1	11
OG0001378	0	0	0	0	4	0	7	11
OG0001379	0	0	0	0	3	0	8	11
OG0001380	0	0	0	0	0	11	0	11
OG0001381	0	0	0	0	0	11	0	11
OG0001382	0	0	0	0	0	0	11	11
OG0001383	0	0	0	0	0	0	11	11
OG0001384	0	0	0	0	0	0	11	11
OG0001385	0	0	0	0	0	0	11	11
OG0001386	0	0	0	0	0	0	11	11
OG0001387	0	0	0	0	0	0	11	11
OG0001388	0	0	0	0	0	0	11	11
OG0001389	0	0	0	0	0	0	11	11
OG0001390	0	0	0	0	0	0	11	11
OG0001391	0	0	0	0	0	0	11	11
OG0001392	0	0	0	0	0	0	11	11
OG0001393	0	0	0	0	0	0	11	11
OG0001394	0	0	0	0	0	0	11	11
OG0001395	7	2	1	0	0	0	0	10
OG0001396	2	1	1	1	3	1	1	10
OG0001397	9	0	1	0	0	0	0	10
OG0001398	2	1	1	2	2	1	1	10
OG0001399	7	1	1	1	0	0	0	10
OG0001400	4	1	1	1	1	1	1	10
OG0001401	4	1	1	1	1	1	1	10
OG0001402	2	1	1	1	1	1	3	10
OG0001403	2	1	1	1	1	1	3	10
OG0001404	2	1	1	2	0	2	2	10
OG0001405	4	1	1	1	1	1	1	10
OG0001406	2	4	2	2	0	0	0	10
OG0001407	2	1	1	1	1	1	3	10
OG0001408	2	1	3	1	1	1	1	10
OG0001409	3	1	1	1	2	1	1	10
OG0001410	3	1	1	1	1	2	1	10
OG0001411	3	1	1	1	1	1	2	10
OG0001412	4	1	1	1	1	1	1	10
OG0001413	2	1	1	1	2	1	2	10
OG0001414	3	1	1	1	1	1	2	10
OG0001415	2	1	1	1	2	1	2	10
OG0001416	2	1	1	1	2	1	2	10
OG0001417	2	1	1	1	2	2	1	10
OG0001418	3	1	1	2	0	2	1	10
OG0001419	3	1	1	1	1	2	1	10
OG0001420	4	1	1	1	1	1	1	10
OG0001421	2	1	1	2	2	1	1	10
OG0001422	2	1	1	2	2	1	1	10
OG0001423	2	1	1	2	2	1	1	10
OG0001424	4	2	2	1	0	1	0	10
OG0001425	5	2	1	2	0	0	0	10
OG0001426	2	1	1	2	2	1	1	10
OG0001427	3	1	1	2	1	1	1	10
OG0001428	2	1	1	1	1	1	3	10
OG0001429	2	1	1	1	1	1	3	10
OG0001430	4	1	1	1	1	1	1	10
OG0001431	3	2	1	1	1	1	1	10
OG0001432	2	1	1	1	2	1	2	10
OG0001433	2	1	1	1	1	1	3	10
OG0001434	3	1	1	1	1	1	2	10
OG0001435	2	1	1	2	1	2	1	10
OG0001436	2	1	1	1	1	1	3	10
OG0001437	4	1	1	1	1	1	1	10
OG0001438	2	1	1	1	1	0	4	10
OG0001439	3	1	1	3	0	1	1	10
OG0001440	2	1	1	1	2	2	1	10
OG0001441	2	1	1	1	3	1	1	10
OG0001442	4	1	1	1	1	1	1	10
OG0001443	4	1	1	1	1	1	1	10
OG0001444	2	1	1	2	1	1	2	10
OG0001445	3	1	1	1	2	1	1	10
OG0001446	2	1	1	1	1	1	3	10
OG0001447	2	1	1	1	1	3	1	10
OG0001448	2	1	1	1	2	1	2	10
OG0001449	3	1	1	1	1	1	2	10
OG0001450	5	2	1	1	0	1	0	10
OG0001451	2	1	1	1	1	2	2	10
OG0001452	3	1	2	1	1	1	1	10
OG0001453	4	1	1	1	1	1	1	10
OG0001454	2	1	0	1	1	1	4	10
OG0001455	3	1	1	1	2	1	1	10
OG0001456	2	1	1	1	1	1	3	10
OG0001457	4	1	1	1	0	1	2	10
OG0001458	2	1	0	1	2	2	2	10
OG0001459	2	1	1	1	2	1	2	10
OG0001460	2	1	1	1	1	1	3	10
OG0001461	3	1	1	2	1	1	1	10
OG0001462	2	1	1	1	1	1	3	10
OG0001463	2	1	1	1	3	1	1	10
OG0001464	2	2	3	2	0	1	0	10
OG0001465	2	1	2	1	1	1	2	10
OG0001466	2	1	2	1	2	1	1	10
OG0001467	2	1	2	1	0	2	2	10
OG0001468	4	1	1	1	1	1	1	10
OG0001469	4	1	1	1	1	1	1	10
OG0001470	2	1	1	1	3	1	1	10
OG0001471	3	1	1	1	1	2	1	10
OG0001472	3	1	1	1	1	1	2	10
OG0001473	3	1	1	1	2	1	1	10
OG0001474	4	1	1	1	0	3	0	10
OG0001475	4	1	1	1	1	1	1	10
OG0001476	10	0	0	0	0	0	0	10
OG0001477	5	1	2	1	0	1	0	10
OG0001478	2	1	1	1	1	2	2	10
OG0001479	2	1	1	1	2	1	2	10
OG0001480	4	1	1	1	0	1	2	10
OG0001481	2	1	1	1	3	1	1	10
OG0001482	4	1	1	1	1	1	1	10
OG0001483	2	1	1	1	1	1	3	10
OG0001484	2	1	1	2	1	2	1	10
OG0001485	3	1	1	2	1	1	1	10
OG0001486	4	1	1	1	1	0	2	10
OG0001487	2	1	1	1	3	1	1	10
OG0001488	4	1	1	1	1	1	1	10
OG0001489	3	1	1	1	2	1	1	10
OG0001490	2	2	1	1	1	2	1	10
OG0001491	2	1	1	1	1	1	3	10
OG0001492	2	1	1	1	2	2	1	10
OG0001493	2	1	4	0	1	1	1	10
OG0001494	2	1	1	1	1	2	2	10
OG0001495	2	1	1	1	1	1	3	10
OG0001496	2	1	1	1	1	3	1	10
OG0001497	2	1	3	1	1	1	1	10
OG0001498	1	1	1	1	3	2	1	10
OG0001499	3	1	1	1	2	1	1	10
OG0001500	2	1	1	1	1	1	3	10
OG0001501	2	1	1	1	1	3	1	10
OG0001502	4	1	1	1	1	1	1	10
OG0001503	2	1	1	1	2	0	3	10
OG0001504	3	1	1	1	1	2	1	10
OG0001505	3	1	1	1	1	1	2	10
OG0001506	2	1	1	1	2	1	2	10
OG0001507	3	1	2	1	2	0	1	10
OG0001508	2	1	1	1	2	1	2	10
OG0001509	6	1	1	1	0	1	0	10
OG0001510	3	1	1	1	1	2	1	10
OG0001511	4	1	1	1	1	1	1	10
OG0001512	2	1	1	1	1	2	2	10
OG0001513	4	1	1	1	1	1	1	10
OG0001514	3	1	1	1	1	2	1	10
OG0001515	2	1	1	1	1	1	3	10
OG0001516	2	1	1	1	1	3	1	10
OG0001517	2	1	1	1	3	1	1	10
OG0001518	2	1	1	1	3	1	1	10
OG0001519	2	2	2	1	1	1	1	10
OG0001520	2	1	1	2	0	1	3	10
OG0001521	3	1	1	2	0	1	2	10
OG0001522	4	1	1	1	1	1	1	10
OG0001523	2	1	1	1	1	2	2	10
OG0001524	3	1	1	2	1	1	1	10
OG0001525	2	2	3	3	0	0	0	10
OG0001526	2	1	1	1	2	1	2	10
OG0001527	4	1	1	1	1	1	1	10
OG0001528	2	1	1	1	2	1	2	10
OG0001529	4	1	1	1	1	1	1	10
OG0001530	2	1	1	2	2	1	1	10
OG0001531	4	1	1	1	1	0	2	10
OG0001532	3	1	1	1	2	1	1	10
OG0001533	2	1	1	1	1	1	3	10
OG0001534	3	1	1	1	2	1	1	10
OG0001535	2	1	3	1	1	1	1	10
OG0001536	2	2	1	1	2	1	1	10
OG0001537	2	1	1	1	2	1	2	10
OG0001538	2	1	1	1	2	1	2	10
OG0001539	2	2	1	2	1	1	1	10
OG0001540	2	1	2	1	1	1	2	10
OG0001541	2	1	1	2	1	1	2	10
OG0001542	3	1	1	1	2	1	1	10
OG0001543	2	1	1	1	2	1	2	10
OG0001544	2	1	1	1	1	2	2	10
OG0001545	2	1	1	1	1	1	3	10
OG0001546	4	1	1	1	1	1	1	10
OG0001547	3	1	1	0	2	0	3	10
OG0001548	2	1	1	3	1	1	1	10
OG0001549	4	1	1	1	1	1	1	10
OG0001550	3	1	1	1	2	1	1	10
OG0001551	4	1	1	2	0	1	1	10
OG0001552	2	2	3	3	0	0	0	10
OG0001553	2	1	1	1	1	1	3	10
OG0001554	2	1	1	1	1	1	3	10
OG0001555	2	1	1	1	1	1	3	10
OG0001556	2	1	1	2	1	2	1	10
OG0001557	6	0	1	1	0	2	0	10
OG0001558	2	1	1	2	2	1	1	10
OG0001559	4	1	1	1	1	1	1	10
OG0001560	2	1	1	1	1	1	3	10
OG0001561	3	1	1	1	2	1	1	10
OG0001562	2	1	1	1	2	1	2	10
OG0001563	2	1	1	1	2	2	1	10
OG0001564	4	1	1	1	1	1	1	10
OG0001565	2	1	1	2	1	1	2	10
OG0001566	2	5	1	1	0	1	0	10
OG0001567	2	1	1	1	1	2	2	10
OG0001568	2	1	1	1	2	1	2	10
OG0001569	3	1	1	1	1	2	1	10
OG0001570	3	1	1	2	1	1	1	10
OG0001571	2	1	1	1	1	1	3	10
OG0001572	3	1	1	1	1	1	2	10
OG0001573	4	1	1	1	1	1	1	10
OG0001574	4	1	1	1	1	1	1	10
OG0001575	2	1	1	1	1	1	3	10
OG0001576	6	1	1	1	0	1	0	10
OG0001577	2	1	1	1	1	1	3	10
OG0001578	3	2	1	1	1	1	1	10
OG0001579	2	1	1	1	1	1	3	10
OG0001580	2	1	0	1	1	1	4	10
OG0001581	2	1	1	1	1	1	3	10
OG0001582	2	1	1	2	1	1	2	10
OG0001583	2	1	1	1	1	3	1	10
OG0001584	3	1	1	1	2	1	1	10
OG0001585	3	1	1	1	1	0	3	10
OG0001586	2	1	1	2	1	1	2	10
OG0001587	2	2	2	1	0	3	0	10
OG0001588	4	1	1	1	1	1	1	10
OG0001589	4	1	1	1	1	1	1	10
OG0001590	2	1	1	1	1	1	3	10
OG0001591	2	1	1	1	1	1	3	10
OG0001592	2	1	1	1	0	1	4	10
OG0001593	2	1	1	1	1	1	3	10
OG0001594	4	1	1	1	1	1	1	10
OG0001595	2	1	1	1	1	1	3	10
OG0001596	2	1	1	1	0	1	4	10
OG0001597	2	1	1	2	1	2	1	10
OG0001598	2	1	1	1	2	2	1	10
OG0001599	3	1	1	1	2	1	1	10
OG0001600	2	1	1	1	2	2	1	10
OG0001601	3	1	1	1	1	2	1	10
OG0001602	2	1	1	2	1	2	1	10
OG0001603	2	1	1	1	1	1	3	10
OG0001604	2	1	1	1	1	1	3	10
OG0001605	3	1	1	1	1	1	2	10
OG0001606	3	1	1	1	1	1	2	10
OG0001607	3	1	1	1	1	1	2	10
OG0001608	3	1	1	1	1	2	1	10
OG0001609	2	1	1	1	1	1	3	10
OG0001610	2	1	1	1	2	1	2	10
OG0001611	2	1	1	1	1	2	2	10
OG0001612	3	1	1	1	1	2	1	10
OG0001613	2	1	1	1	3	1	1	10
OG0001614	2	1	1	1	2	1	2	10
OG0001615	2	1	1	1	2	2	1	10
OG0001616	3	1	1	1	1	1	2	10
OG0001617	2	1	1	2	1	2	1	10
OG0001618	5	1	1	1	0	1	1	10
OG0001619	3	1	1	1	1	2	1	10
OG0001620	2	1	1	1	2	1	2	10
OG0001621	2	1	1	1	1	1	3	10
OG0001622	2	1	1	1	1	3	1	10
OG0001623	3	1	1	1	2	1	1	10
OG0001624	4	1	1	1	1	1	1	10
OG0001625	2	1	1	1	2	1	2	10
OG0001626	2	1	0	1	4	1	1	10
OG0001627	4	1	1	1	1	1	1	10
OG0001628	2	1	1	1	1	1	3	10
OG0001629	3	1	1	1	1	1	2	10
OG0001630	2	1	2	1	2	1	1	10
OG0001631	2	1	1	0	1	1	4	10
OG0001632	2	1	1	1	1	1	3	10
OG0001633	3	1	1	1	1	2	1	10
OG0001634	2	1	1	1	3	1	1	10
OG0001635	2	1	1	1	3	1	1	10
OG0001636	3	1	1	1	1	1	2	10
OG0001637	3	1	1	2	1	1	1	10
OG0001638	2	1	1	1	2	1	2	10
OG0001639	2	1	1	1	2	1	2	10
OG0001640	2	1	1	1	2	1	2	10
OG0001641	2	1	1	1	1	1	3	10
OG0001642	2	1	1	1	2	1	2	10
OG0001643	2	1	1	1	1	1	3	10
OG0001644	2	1	3	1	1	1	1	10
OG0001645	3	1	1	1	3	0	1	10
OG0001646	2	1	1	1	1	1	3	10
OG0001647	3	1	1	1	2	1	1	10
OG0001648	2	1	1	2	1	1	2	10
OG0001649	2	1	1	1	1	1	3	10
OG0001650	2	1	1	1	2	2	1	10
OG0001651	3	1	1	1	1	2	1	10
OG0001652	4	1	1	1	1	1	1	10
OG0001653	2	1	1	2	1	2	1	10
OG0001654	2	1	1	1	2	1	2	10
OG0001655	2	1	1	1	2	2	1	10
OG0001656	2	1	2	1	2	1	1	10
OG0001657	2	1	1	1	3	1	1	10
OG0001658	2	1	1	1	2	1	2	10
OG0001659	4	1	1	1	1	1	1	10
OG0001660	2	1	1	1	1	1	3	10
OG0001661	3	1	1	1	1	2	1	10
OG0001662	3	1	1	1	2	1	1	10
OG0001663	2	1	1	1	3	1	1	10
OG0001664	2	1	1	1	2	2	1	10
OG0001665	3	1	1	2	1	1	1	10
OG0001666	3	1	1	1	2	1	1	10
OG0001667	4	1	1	1	0	2	1	10
OG0001668	2	1	1	1	1	1	3	10
OG0001669	7	1	1	1	0	0	0	10
OG0001670	3	1	1	1	2	1	1	10
OG0001671	2	3	2	3	0	0	0	10
OG0001672	2	1	1	1	1	2	2	10
OG0001673	3	1	1	1	1	1	2	10
OG0001674	2	1	1	1	2	1	2	10
OG0001675	4	1	1	2	0	2	0	10
OG0001676	2	1	1	1	3	1	1	10
OG0001677	2	1	1	1	1	2	2	10
OG0001678	2	1	1	1	3	1	1	10
OG0001679	3	1	1	1	2	1	1	10
OG0001680	2	1	1	1	1	1	3	10
OG0001681	2	1	1	1	2	2	1	10
OG0001682	2	2	1	1	3	1	0	10
OG0001683	2	1	1	1	1	3	1	10
OG0001684	2	1	1	1	2	0	3	10
OG0001685	10	0	0	0	0	0	0	10
OG0001686	3	1	1	3	0	2	0	10
OG0001687	3	1	2	1	0	0	3	10
OG0001688	2	1	1	1	1	1	3	10
OG0001689	4	1	1	1	1	1	1	10
OG0001690	2	1	1	1	2	1	2	10
OG0001691	2	0	3	1	0	4	0	10
OG0001692	2	1	2	2	1	1	1	10
OG0001693	2	1	1	0	3	2	1	10
OG0001694	3	1	1	1	1	2	1	10
OG0001695	2	1	1	2	2	1	1	10
OG0001696	2	1	1	1	2	2	1	10
OG0001697	3	1	1	1	1	1	2	10
OG0001698	2	1	1	1	2	1	2	10
OG0001699	3	1	1	1	1	1	2	10
OG0001700	2	1	1	1	1	1	3	10
OG0001701	2	1	1	1	2	1	2	10
OG0001702	4	1	1	1	1	1	1	10
OG0001703	2	1	0	1	1	1	4	10
OG0001704	2	1	1	2	2	1	1	10
OG0001705	2	1	1	1	2	1	2	10
OG0001706	2	1	1	1	3	1	1	10
OG0001707	2	1	1	1	2	1	2	10
OG0001708	1	1	1	2	3	1	1	10
OG0001709	2	1	1	2	1	1	2	10
OG0001710	1	1	2	1	1	2	2	10
OG0001711	3	1	1	1	1	1	2	10
OG0001712	4	1	1	1	1	1	1	10
OG0001713	3	1	2	1	0	2	1	10
OG0001714	2	1	1	1	1	1	3	10
OG0001715	3	1	1	2	1	1	1	10
OG0001716	3	1	1	1	1	1	2	10
OG0001717	2	1	1	1	2	1	2	10
OG0001718	2	1	1	2	2	1	1	10
OG0001719	2	1	1	1	1	1	3	10
OG0001720	2	1	1	1	2	1	2	10
OG0001721	3	1	1	2	1	1	1	10
OG0001722	3	1	1	1	2	1	1	10
OG0001723	2	1	2	1	1	1	2	10
OG0001724	1	3	1	1	1	1	2	10
OG0001725	3	1	1	1	2	1	1	10
OG0001726	2	1	1	1	1	1	3	10
OG0001727	2	1	1	1	4	0	1	10
OG0001728	2	1	1	1	1	3	1	10
OG0001729	4	1	1	1	0	2	1	10
OG0001730	3	1	1	1	2	1	1	10
OG0001731	3	1	1	1	1	1	2	10
OG0001732	3	1	1	1	2	1	1	10
OG0001733	2	1	1	1	1	1	3	10
OG0001734	2	1	1	1	1	1	3	10
OG0001735	2	1	1	1	1	1	3	10
OG0001736	2	2	1	1	1	2	1	10
OG0001737	2	1	1	1	1	2	2	10
OG0001738	4	1	1	1	1	1	1	10
OG0001739	2	1	2	1	2	1	1	10
OG0001740	3	1	1	0	3	1	1	10
OG0001741	2	1	1	1	1	1	3	10
OG0001742	3	1	1	1	2	1	1	10
OG0001743	2	1	1	1	1	1	3	10
OG0001744	3	1	1	1	2	1	1	10
OG0001745	2	1	2	1	1	2	1	10
OG0001746	2	1	1	1	3	1	1	10
OG0001747	2	2	2	1	1	1	1	10
OG0001748	2	1	1	2	2	1	1	10
OG0001749	3	1	1	1	1	1	2	10
OG0001750	2	1	3	1	1	1	1	10
OG0001751	4	1	4	1	0	0	0	10
OG0001752	2	1	2	1	2	1	1	10
OG0001753	2	1	1	1	1	1	3	10
OG0001754	3	2	1	1	1	1	1	10
OG0001755	2	1	1	2	1	1	2	10
OG0001756	3	1	1	1	1	1	2	10
OG0001757	2	1	1	1	2	1	2	10
OG0001758	2	2	1	1	1	2	1	10
OG0001759	2	1	1	1	2	1	2	10
OG0001760	3	2	0	1	1	1	2	10
OG0001761	3	1	1	2	1	1	1	10
OG0001762	2	1	2	1	2	1	1	10
OG0001763	2	1	1	1	3	1	1	10
OG0001764	2	4	1	1	0	2	0	10
OG0001765	10	0	0	0	0	0	0	10
OG0001766	2	1	1	1	1	1	3	10
OG0001767	2	1	1	1	1	1	3	10
OG0001768	4	2	1	1	0	2	0	10
OG0001769	4	1	1	1	1	1	1	10
OG0001770	2	1	1	1	1	3	1	10
OG0001771	3	1	1	1	2	1	1	10
OG0001772	4	1	1	1	1	1	1	10
OG0001773	2	2	1	2	1	2	0	10
OG0001774	3	1	1	1	1	1	2	10
OG0001775	2	2	1	1	1	1	2	10
OG0001776	2	1	1	1	3	1	1	10
OG0001777	4	1	1	1	1	1	1	10
OG0001778	2	1	1	1	3	1	1	10
OG0001779	4	1	1	1	1	1	1	10
OG0001780	3	0	1	1	1	2	2	10
OG0001781	2	1	1	1	1	1	3	10
OG0001782	2	1	1	2	2	1	1	10
OG0001783	2	1	1	2	2	1	1	10
OG0001784	3	1	2	1	1	1	1	10
OG0001785	4	1	1	1	1	1	1	10
OG0001786	2	2	1	1	2	1	1	10
OG0001787	2	1	1	1	2	1	2	10
OG0001788	2	1	1	1	1	1	3	10
OG0001789	2	1	1	1	1	1	3	10
OG0001790	2	1	1	1	3	0	2	10
OG0001791	3	2	1	1	1	1	1	10
OG0001792	3	1	1	2	1	1	1	10
OG0001793	2	1	1	2	1	1	2	10
OG0001794	2	1	1	1	3	1	1	10
OG0001795	2	1	1	1	2	1	2	10
OG0001796	2	1	1	1	1	1	3	10
OG0001797	5	1	0	1	1	1	1	10
OG0001798	2	1	1	1	2	1	2	10
OG0001799	3	2	0	1	1	1	2	10
OG0001800	2	1	1	1	3	1	1	10
OG0001801	4	1	1	1	1	1	1	10
OG0001802	2	1	1	1	2	1	2	10
OG0001803	2	1	1	1	2	1	2	10
OG0001804	3	1	1	1	1	1	2	10
OG0001805	2	1	1	2	1	2	1	10
OG0001806	2	1	1	1	1	1	3	10
OG0001807	4	1	1	1	1	1	1	10
OG0001808	2	1	1	1	1	1	3	10
OG0001809	2	1	1	1	1	1	3	10
OG0001810	4	1	1	1	1	1	1	10
OG0001811	2	1	2	1	1	1	2	10
OG0001812	2	1	1	1	1	1	3	10
OG0001813	2	1	1	1	1	2	2	10
OG0001814	2	1	1	1	1	1	3	10
OG0001815	2	1	1	0	1	1	4	10
OG0001816	2	1	1	1	1	1	3	10
OG0001817	4	1	1	1	1	1	1	10
OG0001818	2	1	1	1	1	1	3	10
OG0001819	2	1	1	1	3	1	1	10
OG0001820	3	1	1	1	0	1	3	10
OG0001821	2	1	1	1	1	1	3	10
OG0001822	3	1	1	2	1	1	1	10
OG0001823	3	1	1	1	1	1	2	10
OG0001824	2	1	1	1	1	1	3	10
OG0001825	3	1	1	2	1	1	1	10
OG0001826	3	1	1	1	1	1	2	10
OG0001827	2	2	1	2	1	1	1	10
OG0001828	3	1	0	1	2	1	2	10
OG0001829	2	1	1	1	1	1	3	10
OG0001830	2	1	1	1	3	1	1	10
OG0001831	2	1	0	1	2	1	3	10
OG0001832	5	1	1	2	0	1	0	10
OG0001833	3	1	1	2	1	1	1	10
OG0001834	2	1	1	1	1	1	3	10
OG0001835	2	1	1	1	2	2	1	10
OG0001836	5	1	1	1	0	1	1	10
OG0001837	2	1	1	1	2	2	1	10
OG0001838	3	1	1	1	2	1	1	10
OG0001839	2	1	3	1	1	1	1	10
OG0001840	3	1	1	2	1	1	1	10
OG0001841	2	1	1	4	0	2	0	10
OG0001842	2	1	1	2	1	1	2	10
OG0001843	2	2	1	2	1	1	1	10
OG0001844	2	1	1	1	1	1	3	10
OG0001845	2	1	1	1	2	1	2	10
OG0001846	3	2	1	1	1	1	1	10
OG0001847	2	1	1	3	1	1	1	10
OG0001848	3	1	1	1	1	1	2	10
OG0001849	3	1	1	1	1	1	2	10
OG0001850	4	1	1	1	1	1	1	10
OG0001851	4	1	1	1	0	1	2	10
OG0001852	2	1	1	1	1	1	3	10
OG0001853	3	1	2	1	1	1	1	10
OG0001854	3	1	1	1	2	1	1	10
OG0001855	2	1	1	1	2	1	2	10
OG0001856	3	1	1	1	2	1	1	10
OG0001857	2	1	1	1	2	2	1	10
OG0001858	2	1	1	1	2	1	2	10
OG0001859	2	2	1	0	1	2	2	10
OG0001860	5	1	3	1	0	0	0	10
OG0001861	2	1	1	1	3	1	1	10
OG0001862	3	2	1	1	1	1	1	10
OG0001863	3	1	1	2	1	1	1	10
OG0001864	2	1	1	1	2	1	2	10
OG0001865	3	1	1	1	1	0	3	10
OG0001866	2	1	1	2	1	1	2	10
OG0001867	4	1	1	2	0	2	0	10
OG0001868	2	1	1	1	3	1	1	10
OG0001869	3	1	1	1	1	1	2	10
OG0001870	3	1	1	1	1	1	2	10
OG0001871	3	1	1	1	1	1	2	10
OG0001872	2	1	2	4	0	1	0	10
OG0001873	3	1	1	1	2	1	1	10
OG0001874	2	1	1	1	2	1	2	10
OG0001875	3	1	1	1	1	1	2	10
OG0001876	2	1	1	1	3	1	1	10
OG0001877	2	1	1	1	2	1	2	10
OG0001878	1	4	3	2	0	0	0	10
OG0001879	1	1	2	1	2	1	2	10
OG0001880	2	1	1	1	1	1	3	10
OG0001881	2	1	1	1	0	5	0	10
OG0001882	4	1	1	1	1	1	1	10
OG0001883	2	1	1	1	3	1	1	10
OG0001884	2	1	1	1	3	1	1	10
OG0001885	3	0	0	1	2	1	3	10
OG0001886	4	1	1	1	1	1	1	10
OG0001887	4	1	1	1	1	1	1	10
OG0001888	3	1	2	2	0	1	1	10
OG0001889	2	1	1	1	3	1	1	10
OG0001890	2	1	1	2	1	2	1	10
OG0001891	1	1	1	2	2	1	2	10
OG0001892	3	1	2	1	1	1	1	10
OG0001893	2	1	2	1	1	2	1	10
OG0001894	2	1	1	1	1	1	3	10
OG0001895	2	1	1	1	2	1	2	10
OG0001896	4	1	1	1	1	1	1	10
OG0001897	4	1	1	1	1	1	1	10
OG0001898	2	1	1	2	1	2	1	10
OG0001899	2	1	1	1	2	1	2	10
OG0001900	2	1	1	1	2	2	1	10
OG0001901	3	1	1	1	1	1	2	10
OG0001902	2	1	1	1	2	1	2	10
OG0001903	2	1	1	1	1	1	3	10
OG0001904	2	1	1	1	1	2	2	10
OG0001905	2	1	1	1	3	1	1	10
OG0001906	2	1	2	2	1	1	1	10
OG0001907	1	1	1	1	1	1	4	10
OG0001908	3	1	1	1	2	1	1	10
OG0001909	4	1	2	1	0	2	0	10
OG0001910	4	1	1	1	1	1	1	10
OG0001911	2	1	1	1	1	1	3	10
OG0001912	3	1	1	1	1	1	2	10
OG0001913	2	1	1	1	2	1	2	10
OG0001914	2	1	1	1	1	2	2	10
OG0001915	2	1	1	1	3	1	1	10
OG0001916	2	1	1	2	2	1	1	10
OG0001917	2	1	1	1	1	1	3	10
OG0001918	8	0	1	0	0	0	1	10
OG0001919	3	1	1	1	2	1	1	10
OG0001920	3	1	1	1	2	1	1	10
OG0001921	4	1	1	1	1	1	1	10
OG0001922	2	1	2	1	2	1	1	10
OG0001923	2	1	1	1	1	3	1	10
OG0001924	2	1	1	1	2	1	2	10
OG0001925	2	1	1	2	1	2	1	10
OG0001926	3	1	1	1	0	1	3	10
OG0001927	4	1	1	1	1	1	1	10
OG0001928	4	1	1	1	1	1	1	10
OG0001929	2	1	1	1	1	2	2	10
OG0001930	2	1	1	1	2	1	2	10
OG0001931	1	2	2	2	1	1	1	10
OG0001932	2	1	1	1	1	1	3	10
OG0001933	2	1	1	1	2	2	1	10
OG0001934	2	1	1	1	1	1	3	10
OG0001935	2	1	1	1	1	1	3	10
OG0001936	2	1	1	1	1	1	3	10
OG0001937	2	1	2	1	1	1	2	10
OG0001938	2	1	1	1	1	1	3	10
OG0001939	5	1	3	1	0	0	0	10
OG0001940	1	1	1	1	2	2	2	10
OG0001941	2	1	1	1	1	1	3	10
OG0001942	2	2	1	2	1	1	1	10
OG0001943	3	1	1	2	1	1	1	10
OG0001944	2	1	1	1	1	1	3	10
OG0001945	2	1	1	1	1	2	2	10
OG0001946	2	1	1	1	1	1	3	10
OG0001947	2	1	1	1	0	1	4	10
OG0001948	2	1	1	1	1	2	2	10
OG0001949	2	1	1	1	2	2	1	10
OG0001950	3	1	1	1	1	1	2	10
OG0001951	2	1	1	1	2	1	2	10
OG0001952	2	1	1	1	1	1	3	10
OG0001953	3	1	1	1	2	1	1	10
OG0001954	2	2	1	2	1	1	1	10
OG0001955	2	1	1	1	1	1	3	10
OG0001956	2	1	1	1	2	2	1	10
OG0001957	4	1	1	1	1	1	1	10
OG0001958	2	2	1	1	2	1	1	10
OG0001959	2	1	1	1	1	1	3	10
OG0001960	2	1	1	1	1	1	3	10
OG0001961	2	1	1	1	2	2	1	10
OG0001962	2	1	1	1	2	2	1	10
OG0001963	2	1	1	1	1	2	2	10
OG0001964	2	1	1	1	2	1	2	10
OG0001965	2	1	2	1	2	1	1	10
OG0001966	2	1	1	1	1	2	2	10
OG0001967	1	1	1	1	2	1	3	10
OG0001968	2	1	1	1	1	1	3	10
OG0001969	2	1	1	1	1	1	3	10
OG0001970	2	1	1	1	1	1	3	10
OG0001971	3	1	4	2	0	0	0	10
OG0001972	5	1	1	1	1	0	1	10
OG0001973	3	1	1	1	2	1	1	10
OG0001974	3	1	1	1	2	1	1	10
OG0001975	2	1	1	2	1	2	1	10
OG0001976	3	1	1	1	1	1	2	10
OG0001977	2	1	1	1	3	1	1	10
OG0001978	2	1	1	1	1	1	3	10
OG0001979	2	1	1	1	1	1	3	10
OG0001980	1	1	1	2	1	2	2	10
OG0001981	1	1	2	1	1	1	3	10
OG0001982	1	1	1	1	3	1	2	10
OG0001983	10	0	0	0	0	0	0	10
OG0001984	3	0	1	1	2	1	2	10
OG0001985	2	1	2	1	1	1	2	10
OG0001986	2	1	3	1	1	1	1	10
OG0001987	1	0	5	4	0	0	0	10
OG0001988	0	10	0	0	0	0	0	10
OG0001989	0	2	1	1	1	1	4	10
OG0001990	0	10	0	0	0	0	0	10
OG0001991	0	1	3	1	1	4	0	10
OG0001992	0	9	1	0	0	0	0	10
OG0001993	0	1	9	0	0	0	0	10
OG0001994	0	1	0	9	0	0	0	10
OG0001995	0	1	9	0	0	0	0	10
OG0001996	0	7	0	3	0	0	0	10
OG0001997	0	1	6	3	0	0	0	10
OG0001998	0	0	9	1	0	0	0	10
OG0001999	0	0	10	0	0	0	0	10
OG0002000	0	0	10	0	0	0	0	10
OG0002001	0	0	10	0	0	0	0	10
OG0002002	0	0	2	8	0	0	0	10
OG0002003	0	0	5	1	1	0	3	10
OG0002004	0	0	10	0	0	0	0	10
OG0002005	0	0	10	0	0	0	0	10
OG0002006	0	0	10	0	0	0	0	10
OG0002007	0	0	10	0	0	0	0	10
OG0002008	0	0	0	10	0	0	0	10
OG0002009	0	0	0	10	0	0	0	10
OG0002010	0	0	0	10	0	0	0	10
OG0002011	0	0	0	10	0	0	0	10
OG0002012	0	0	0	10	0	0	0	10
OG0002013	0	0	0	0	10	0	0	10
OG0002014	0	0	0	0	9	1	0	10
OG0002015	0	0	0	0	9	0	1	10
OG0002016	0	0	0	0	6	0	4	10
OG0002017	0	0	0	0	2	2	6	10
OG0002018	0	0	0	0	3	0	7	10
OG0002019	0	0	0	0	10	0	0	10
OG0002020	0	0	0	0	10	0	0	10
OG0002021	0	0	0	0	1	0	9	10
OG0002022	0	0	0	0	5	0	5	10
OG0002023	0	0	0	0	4	2	4	10
OG0002024	0	0	0	0	1	2	7	10
OG0002025	0	0	0	0	1	0	9	10
OG0002026	0	0	0	0	0	10	0	10
OG0002027	0	0	0	0	0	10	0	10
OG0002028	0	0	0	0	0	10	0	10
OG0002029	0	0	0	0	0	9	1	10
OG0002030	0	0	0	0	0	10	0	10
OG0002031	0	0	0	0	0	10	0	10
OG0002032	0	0	0	0	0	10	0	10
OG0002033	0	0	0	0	0	1	9	10
OG0002034	0	0	0	0	0	0	10	10
OG0002035	0	0	0	0	0	0	10	10
OG0002036	0	0	0	0	0	0	10	10
OG0002037	0	0	0	0	0	0	10	10
OG0002038	0	0	0	0	0	0	10	10
OG0002039	0	0	0	0	0	0	10	10
OG0002040	0	0	0	0	0	0	10	10
OG0002041	0	0	0	0	0	0	10	10
OG0002042	0	0	0	0	0	0	10	10
OG0002043	0	0	0	0	0	0	10	10
OG0002044	0	0	0	0	0	0	10	10
OG0002045	0	0	0	0	0	0	10	10
OG0002046	0	0	0	0	0	0	10	10
OG0002047	0	0	0	0	0	0	10	10
OG0002048	3	1	1	1	1	1	1	9
OG0002049	2	1	1	2	1	1	1	9
OG0002050	2	1	1	2	1	1	1	9
OG0002051	2	1	1	1	2	1	1	9
OG0002052	3	1	1	1	1	1	1	9
OG0002053	3	0	4	2	0	0	0	9
OG0002054	2	1	1	2	1	1	1	9
OG0002055	2	1	1	1	1	1	2	9
OG0002056	2	2	1	1	1	1	1	9
OG0002057	2	1	1	1	1	2	1	9
OG0002058	2	1	1	1	0	1	3	9
OG0002059	2	1	1	1	2	1	1	9
OG0002060	3	1	1	1	1	1	1	9
OG0002061	2	1	1	1	2	1	1	9
OG0002062	2	1	1	1	2	1	1	9
OG0002063	2	1	1	1	1	1	2	9
OG0002064	2	1	1	2	1	1	1	9
OG0002065	2	1	1	2	1	1	1	9
OG0002066	2	1	1	1	1	1	2	9
OG0002067	3	1	1	1	1	1	1	9
OG0002068	2	1	1	1	2	0	2	9
OG0002069	2	1	1	1	1	1	2	9
OG0002070	2	1	1	2	1	1	1	9
OG0002071	1	1	1	1	2	1	2	9
OG0002072	3	1	1	0	1	1	2	9
OG0002073	2	1	2	1	1	1	1	9
OG0002074	4	1	2	1	0	1	0	9
OG0002075	2	1	2	1	1	1	1	9
OG0002076	2	1	1	1	1	0	3	9
OG0002077	2	1	1	1	2	1	1	9
OG0002078	2	2	1	1	0	3	0	9
OG0002079	2	1	2	1	1	1	1	9
OG0002080	3	1	1	1	1	1	1	9
OG0002081	4	1	1	1	1	0	1	9
OG0002082	4	1	1	2	0	1	0	9
OG0002083	3	1	1	1	1	1	1	9
OG0002084	2	1	1	2	1	1	1	9
OG0002085	2	1	1	1	2	1	1	9
OG0002086	2	1	1	1	2	1	1	9
OG0002087	2	1	2	1	1	1	1	9
OG0002088	2	1	1	1	2	1	1	9
OG0002089	3	1	1	1	1	1	1	9
OG0002090	2	1	1	1	2	1	1	9
OG0002091	2	1	1	1	1	0	3	9
OG0002092	2	1	1	1	2	1	1	9
OG0002093	2	1	1	1	1	1	2	9
OG0002094	2	1	1	1	1	1	2	9
OG0002095	2	1	1	2	1	1	1	9
OG0002096	2	1	1	1	1	2	1	9
OG0002097	3	1	1	1	1	0	2	9
OG0002098	2	1	1	1	1	1	2	9
OG0002099	2	1	1	2	1	1	1	9
OG0002100	2	1	1	2	1	1	1	9
OG0002101	2	1	1	1	2	1	1	9
OG0002102	2	1	1	1	2	1	1	9
OG0002103	2	1	1	1	2	1	1	9
OG0002104	2	1	1	2	1	1	1	9
OG0002105	3	1	1	1	1	1	1	9
OG0002106	3	1	1	1	0	2	1	9
OG0002107	2	1	1	1	1	1	2	9
OG0002108	2	1	1	1	1	1	2	9
OG0002109	2	1	1	1	1	1	2	9
OG0002110	3	1	1	1	1	1	1	9
OG0002111	3	1	1	1	1	1	1	9
OG0002112	2	1	1	1	2	1	1	9
OG0002113	2	1	1	1	1	1	2	9
OG0002114	4	1	1	1	0	1	1	9
OG0002115	2	2	1	3	0	1	0	9
OG0002116	2	1	1	2	1	1	1	9
OG0002117	2	1	1	1	1	2	1	9
OG0002118	2	1	1	1	2	1	1	9
OG0002119	2	1	1	0	1	1	3	9
OG0002120	2	0	1	0	1	1	4	9
OG0002121	2	1	1	1	2	1	1	9
OG0002122	2	1	2	1	1	1	1	9
OG0002123	2	1	1	1	1	1	2	9
OG0002124	3	1	1	1	1	1	1	9
OG0002125	2	1	1	1	1	1	2	9
OG0002126	2	1	1	1	1	2	1	9
OG0002127	3	1	1	1	1	1	1	9
OG0002128	2	1	1	1	2	1	1	9
OG0002129	3	1	1	1	1	1	1	9
OG0002130	2	1	1	2	1	1	1	9
OG0002131	1	1	1	1	1	1	3	9
OG0002132	2	1	1	1	2	1	1	9
OG0002133	2	1	1	1	1	1	2	9
OG0002134	2	1	1	1	2	1	1	9
OG0002135	2	1	1	1	1	1	2	9
OG0002136	2	1	1	1	2	1	1	9
OG0002137	3	1	1	1	1	1	1	9
OG0002138	3	1	1	1	1	1	1	9
OG0002139	2	1	1	1	1	2	1	9
OG0002140	2	1	1	1	2	1	1	9
OG0002141	2	1	1	1	3	0	1	9
OG0002142	2	2	1	1	1	1	1	9
OG0002143	2	1	1	1	1	1	2	9
OG0002144	2	1	1	1	2	1	1	9
OG0002145	2	1	1	1	1	1	2	9
OG0002146	2	1	1	1	2	1	1	9
OG0002147	2	1	1	1	2	1	1	9
OG0002148	2	1	0	3	0	1	2	9
OG0002149	2	1	1	1	1	1	2	9
OG0002150	2	1	1	2	0	3	0	9
OG0002151	4	1	1	2	0	1	0	9
OG0002152	2	1	1	1	1	2	1	9
OG0002153	2	1	1	1	1	1	2	9
OG0002154	3	1	1	1	1	1	1	9
OG0002155	2	1	1	0	1	2	2	9
OG0002156	2	1	1	1	2	1	1	9
OG0002157	2	1	1	1	1	1	2	9
OG0002158	2	1	1	1	2	1	1	9
OG0002159	2	2	2	3	0	0	0	9
OG0002160	3	1	1	1	1	1	1	9
OG0002161	3	1	1	1	1	1	1	9
OG0002162	9	0	0	0	0	0	0	9
OG0002163	3	1	1	1	1	1	1	9
OG0002164	3	1	1	1	1	1	1	9
OG0002165	3	1	1	1	1	1	1	9
OG0002166	2	1	1	0	1	3	1	9
OG0002167	3	1	1	1	1	1	1	9
OG0002168	2	1	1	1	2	1	1	9
OG0002169	3	1	1	1	1	1	1	9
OG0002170	1	1	1	1	2	1	2	9
OG0002171	2	4	0	1	1	0	1	9
OG0002172	2	2	2	2	0	1	0	9
OG0002173	2	2	1	1	1	1	1	9
OG0002174	2	1	1	1	1	1	2	9
OG0002175	2	1	1	1	2	1	1	9
OG0002176	2	1	1	1	2	1	1	9
OG0002177	3	1	2	1	0	1	1	9
OG0002178	2	1	1	1	2	1	1	9
OG0002179	2	1	1	1	1	1	2	9
OG0002180	3	1	1	1	1	1	1	9
OG0002181	2	1	1	1	1	2	1	9
OG0002182	9	0	0	0	0	0	0	9
OG0002183	2	1	1	1	2	1	1	9
OG0002184	2	1	1	1	2	1	1	9
OG0002185	3	1	1	1	1	2	0	9
OG0002186	2	1	2	1	1	1	1	9
OG0002187	5	1	1	1	0	1	0	9
OG0002188	3	1	1	1	1	1	1	9
OG0002189	3	1	1	1	1	1	1	9
OG0002190	3	1	1	1	1	1	1	9
OG0002191	2	1	1	1	2	1	1	9
OG0002192	2	1	1	1	2	1	1	9
OG0002193	3	1	1	1	1	1	1	9
OG0002194	2	1	1	1	2	1	1	9
OG0002195	2	1	1	1	1	1	2	9
OG0002196	3	1	1	1	1	1	1	9
OG0002197	1	1	1	1	2	2	1	9
OG0002198	3	1	1	1	1	1	1	9
OG0002199	2	1	1	1	1	0	3	9
OG0002200	3	1	1	1	1	1	1	9
OG0002201	4	2	1	1	0	1	0	9
OG0002202	2	1	1	1	2	1	1	9
OG0002203	2	1	1	2	1	1	1	9
OG0002204	3	1	1	1	1	1	1	9
OG0002205	2	1	1	1	1	1	2	9
OG0002206	5	1	1	1	0	1	0	9
OG0002207	2	1	1	1	1	2	1	9
OG0002208	2	1	1	2	1	1	1	9
OG0002209	2	1	1	1	2	1	1	9
OG0002210	2	1	1	1	2	1	1	9
OG0002211	3	1	1	1	1	1	1	9
OG0002212	2	1	1	1	2	2	0	9
OG0002213	2	1	1	2	1	1	1	9
OG0002214	2	1	1	1	2	1	1	9
OG0002215	2	1	1	1	2	1	1	9
OG0002216	3	1	1	1	1	1	1	9
OG0002217	2	1	1	1	1	1	2	9
OG0002218	3	1	1	1	1	1	1	9
OG0002219	2	1	1	1	1	1	2	9
OG0002220	2	1	1	1	1	2	1	9
OG0002221	3	1	1	1	1	1	1	9
OG0002222	2	1	1	1	1	1	2	9
OG0002223	2	1	1	1	2	1	1	9
OG0002224	2	1	1	1	2	1	1	9
OG0002225	2	1	1	1	0	1	3	9
OG0002226	2	1	1	1	2	1	1	9
OG0002227	2	1	1	1	1	1	2	9
OG0002228	2	1	1	1	2	1	1	9
OG0002229	2	1	1	1	1	1	2	9
OG0002230	3	1	1	2	0	0	2	9
OG0002231	2	1	1	2	1	1	1	9
OG0002232	2	1	1	1	1	1	2	9
OG0002233	1	0	0	0	1	1	6	9
OG0002234	2	1	1	1	2	1	1	9
OG0002235	2	1	1	2	2	1	0	9
OG0002236	8	0	1	0	0	0	0	9
OG0002237	2	2	1	1	1	1	1	9
OG0002238	3	1	1	1	1	1	1	9
OG0002239	3	1	1	1	1	1	1	9
OG0002240	3	1	1	1	1	1	1	9
OG0002241	2	1	1	1	1	2	1	9
OG0002242	3	1	1	1	1	1	1	9
OG0002243	3	1	1	1	1	1	1	9
OG0002244	2	1	1	1	1	1	2	9
OG0002245	2	2	1	2	0	2	0	9
OG0002246	3	1	1	1	1	1	1	9
OG0002247	2	1	1	1	2	1	1	9
OG0002248	3	1	1	1	1	1	1	9
OG0002249	2	1	1	1	1	2	1	9
OG0002250	2	1	1	1	1	2	1	9
OG0002251	2	2	1	1	1	1	1	9
OG0002252	3	1	0	1	1	1	2	9
OG0002253	2	1	1	1	1	2	1	9
OG0002254	2	1	2	1	1	1	1	9
OG0002255	9	0	0	0	0	0	0	9
OG0002256	3	1	1	1	1	1	1	9
OG0002257	2	1	0	2	1	2	1	9
OG0002258	2	1	2	1	0	2	1	9
OG0002259	2	1	1	1	2	1	1	9
OG0002260	2	1	1	1	1	1	2	9
OG0002261	2	1	1	1	1	2	1	9
OG0002262	2	1	1	1	0	1	3	9
OG0002263	2	1	1	2	1	1	1	9
OG0002264	2	1	1	1	0	4	0	9
OG0002265	2	1	1	1	1	1	2	9
OG0002266	2	1	1	1	2	1	1	9
OG0002267	3	1	1	1	1	1	1	9
OG0002268	3	1	1	2	0	2	0	9
OG0002269	9	0	0	0	0	0	0	9
OG0002270	2	1	1	1	1	1	2	9
OG0002271	2	1	1	1	1	1	2	9
OG0002272	2	1	1	1	1	2	1	9
OG0002273	2	1	1	1	1	1	2	9
OG0002274	3	1	1	1	1	1	1	9
OG0002275	2	2	1	1	1	1	1	9
OG0002276	3	1	2	0	1	1	1	9
OG0002277	2	1	1	1	1	1	2	9
OG0002278	2	1	1	1	1	2	1	9
OG0002279	2	1	1	1	2	1	1	9
OG0002280	2	1	1	2	1	1	1	9
OG0002281	2	1	1	1	1	2	1	9
OG0002282	3	1	1	1	1	1	1	9
OG0002283	3	1	1	1	1	1	1	9
OG0002284	2	1	1	1	2	1	1	9
OG0002285	2	1	1	1	1	1	2	9
OG0002286	2	1	1	1	0	2	2	9
OG0002287	4	0	0	0	0	5	0	9
OG0002288	2	2	1	2	0	2	0	9
OG0002289	1	1	1	1	3	1	1	9
OG0002290	2	1	1	1	1	1	2	9
OG0002291	2	1	1	2	1	1	1	9
OG0002292	2	1	1	2	1	1	1	9
OG0002293	3	1	1	1	1	1	1	9
OG0002294	2	1	1	2	1	1	1	9
OG0002295	2	1	1	1	1	0	3	9
OG0002296	1	1	2	1	1	1	2	9
OG0002297	2	1	1	1	1	1	2	9
OG0002298	5	0	2	2	0	0	0	9
OG0002299	2	1	1	1	1	1	2	9
OG0002300	2	2	0	2	2	0	1	9
OG0002301	4	1	1	2	0	1	0	9
OG0002302	2	1	1	1	2	1	1	9
OG0002303	3	1	1	1	1	1	1	9
OG0002304	2	1	1	2	1	1	1	9
OG0002305	2	1	1	1	2	1	1	9
OG0002306	2	1	1	1	2	1	1	9
OG0002307	3	2	1	1	1	0	1	9
OG0002308	3	1	2	1	1	0	1	9
OG0002309	2	1	1	0	1	1	3	9
OG0002310	5	1	2	1	0	0	0	9
OG0002311	3	1	1	1	1	1	1	9
OG0002312	2	1	1	1	2	1	1	9
OG0002313	2	1	1	1	1	2	1	9
OG0002314	2	1	1	1	2	1	1	9
OG0002315	2	1	1	1	2	1	1	9
OG0002316	2	1	1	1	1	0	3	9
OG0002317	3	1	1	1	1	1	1	9
OG0002318	2	2	1	1	1	1	1	9
OG0002319	2	1	1	2	1	1	1	9
OG0002320	2	1	1	1	2	1	1	9
OG0002321	2	1	1	1	2	1	1	9
OG0002322	2	1	2	1	1	0	2	9
OG0002323	3	1	1	1	1	1	1	9
OG0002324	2	1	1	1	2	1	1	9
OG0002325	5	1	1	1	0	1	0	9
OG0002326	2	1	1	1	2	1	1	9
OG0002327	2	1	1	1	2	1	1	9
OG0002328	2	1	1	1	1	1	2	9
OG0002329	3	0	1	2	1	1	1	9
OG0002330	3	1	1	1	1	1	1	9
OG0002331	3	1	1	1	1	1	1	9
OG0002332	3	1	1	1	1	1	1	9
OG0002333	3	1	1	3	0	1	0	9
OG0002334	2	1	1	1	2	1	1	9
OG0002335	2	1	1	1	2	1	1	9
OG0002336	2	1	1	1	2	1	1	9
OG0002337	2	1	1	1	2	1	1	9
OG0002338	2	1	1	1	2	1	1	9
OG0002339	2	1	1	1	2	1	1	9
OG0002340	2	1	1	1	2	1	1	9
OG0002341	3	1	1	1	1	1	1	9
OG0002342	1	1	1	1	3	1	1	9
OG0002343	2	1	1	1	1	1	2	9
OG0002344	2	1	1	1	2	1	1	9
OG0002345	2	1	1	2	1	1	1	9
OG0002346	2	1	1	1	2	0	2	9
OG0002347	9	0	0	0	0	0	0	9
OG0002348	3	1	1	1	1	1	1	9
OG0002349	3	1	1	1	1	1	1	9
OG0002350	2	1	1	1	2	1	1	9
OG0002351	2	1	1	1	1	1	2	9
OG0002352	2	1	1	2	1	1	1	9
OG0002353	2	1	1	1	1	1	2	9
OG0002354	2	1	1	1	1	1	2	9
OG0002355	3	1	1	1	1	1	1	9
OG0002356	3	1	1	1	1	1	1	9
OG0002357	3	1	1	1	1	1	1	9
OG0002358	2	1	1	1	2	1	1	9
OG0002359	2	1	1	1	1	2	1	9
OG0002360	2	1	0	1	1	1	3	9
OG0002361	3	1	1	1	1	1	1	9
OG0002362	2	1	1	1	1	1	2	9
OG0002363	2	1	1	1	1	1	2	9
OG0002364	9	0	0	0	0	0	0	9
OG0002365	5	1	1	1	0	1	0	9
OG0002366	3	1	1	1	1	1	1	9
OG0002367	2	1	1	1	0	2	2	9
OG0002368	2	1	1	1	2	1	1	9
OG0002369	2	1	3	2	0	1	0	9
OG0002370	6	1	1	1	0	0	0	9
OG0002371	2	1	1	1	2	1	1	9
OG0002372	3	1	4	1	0	0	0	9
OG0002373	2	1	1	1	1	2	1	9
OG0002374	3	1	1	1	1	1	1	9
OG0002375	2	1	1	1	2	1	1	9
OG0002376	2	1	0	1	2	1	2	9
OG0002377	2	1	1	2	1	1	1	9
OG0002378	2	0	1	1	2	1	2	9
OG0002379	2	1	1	1	2	1	1	9
OG0002380	3	1	1	1	2	0	1	9
OG0002381	2	1	1	1	2	1	1	9
OG0002382	2	1	1	1	2	1	1	9
OG0002383	9	0	0	0	0	0	0	9
OG0002384	4	1	1	0	1	1	1	9
OG0002385	2	1	1	1	1	1	2	9
OG0002386	2	1	1	1	2	1	1	9
OG0002387	3	1	1	1	1	1	1	9
OG0002388	2	1	1	0	1	1	3	9
OG0002389	2	1	1	1	1	1	2	9
OG0002390	1	1	1	1	1	1	3	9
OG0002391	3	1	1	1	1	1	1	9
OG0002392	2	1	1	1	0	1	3	9
OG0002393	3	1	1	1	1	1	1	9
OG0002394	3	1	1	0	2	1	1	9
OG0002395	2	1	1	1	2	1	1	9
OG0002396	2	1	1	1	1	1	2	9
OG0002397	2	2	1	1	1	1	1	9
OG0002398	2	1	1	1	2	1	1	9
OG0002399	3	1	1	1	1	1	1	9
OG0002400	2	1	1	1	2	1	1	9
OG0002401	2	1	1	1	2	1	1	9
OG0002402	3	1	1	1	1	1	1	9
OG0002403	2	1	1	1	1	2	1	9
OG0002404	2	0	1	2	2	1	1	9
OG0002405	2	2	1	2	0	1	1	9
OG0002406	2	1	1	1	1	1	2	9
OG0002407	2	1	1	1	1	1	2	9
OG0002408	2	1	1	2	1	1	1	9
OG0002409	2	1	2	1	1	1	1	9
OG0002410	2	1	1	1	1	2	1	9
OG0002411	3	1	1	1	1	1	1	9
OG0002412	2	1	1	1	2	1	1	9
OG0002413	4	1	2	1	0	1	0	9
OG0002414	2	1	1	1	1	1	2	9
OG0002415	3	1	1	1	1	1	1	9
OG0002416	2	1	1	1	2	1	1	9
OG0002417	2	1	1	1	2	1	1	9
OG0002418	2	1	2	1	1	1	1	9
OG0002419	3	1	1	1	1	1	1	9
OG0002420	2	1	2	1	1	1	1	9
OG0002421	3	1	1	1	1	1	1	9
OG0002422	2	1	1	1	1	1	2	9
OG0002423	4	1	1	1	0	2	0	9
OG0002424	2	1	1	1	2	1	1	9
OG0002425	5	1	1	1	0	1	0	9
OG0002426	2	1	1	1	2	1	1	9
OG0002427	3	1	1	1	1	1	1	9
OG0002428	2	1	1	1	2	1	1	9
OG0002429	2	1	1	1	1	1	2	9
OG0002430	2	1	1	1	2	1	1	9
OG0002431	1	1	1	1	2	2	1	9
OG0002432	3	1	1	1	1	1	1	9
OG0002433	3	1	1	1	1	1	1	9
OG0002434	3	1	1	0	1	1	2	9
OG0002435	3	1	1	1	1	1	1	9
OG0002436	2	1	1	1	1	1	2	9
OG0002437	6	1	1	1	0	0	0	9
OG0002438	2	1	1	1	2	1	1	9
OG0002439	2	1	1	1	1	1	2	9
OG0002440	1	1	1	1	4	0	1	9
OG0002441	1	1	1	2	1	1	2	9
OG0002442	1	1	1	1	2	2	1	9
OG0002443	3	1	1	1	1	1	1	9
OG0002444	3	1	1	1	1	1	1	9
OG0002445	3	1	1	1	1	1	1	9
OG0002446	2	1	1	2	1	1	1	9
OG0002447	2	1	1	1	2	1	1	9
OG0002448	2	1	1	1	1	2	1	9
OG0002449	2	1	1	1	2	1	1	9
OG0002450	2	1	1	1	2	1	1	9
OG0002451	2	1	1	1	1	1	2	9
OG0002452	2	1	1	2	1	1	1	9
OG0002453	2	1	1	1	2	1	1	9
OG0002454	2	1	1	2	1	1	1	9
OG0002455	3	1	1	1	1	1	1	9
OG0002456	2	1	1	1	2	1	1	9
OG0002457	2	1	1	2	1	1	1	9
OG0002458	2	1	2	1	1	1	1	9
OG0002459	2	1	1	1	1	1	2	9
OG0002460	2	1	1	1	2	0	2	9
OG0002461	2	1	1	1	2	1	1	9
OG0002462	3	1	1	1	1	1	1	9
OG0002463	2	1	1	1	1	2	1	9
OG0002464	2	1	1	2	1	1	1	9
OG0002465	2	1	1	1	1	1	2	9
OG0002466	4	1	1	1	0	1	1	9
OG0002467	2	1	1	2	1	1	1	9
OG0002468	3	1	1	1	1	1	1	9
OG0002469	2	3	1	3	0	0	0	9
OG0002470	3	1	1	1	1	1	1	9
OG0002471	3	1	1	2	0	2	0	9
OG0002472	2	1	1	1	2	1	1	9
OG0002473	2	2	1	1	1	1	1	9
OG0002474	3	1	1	1	1	1	1	9
OG0002475	2	1	1	2	1	1	1	9
OG0002476	5	1	1	2	0	0	0	9
OG0002477	2	1	1	1	2	1	1	9
OG0002478	1	1	1	1	1	1	3	9
OG0002479	2	1	1	1	1	1	2	9
OG0002480	2	1	1	0	3	1	1	9
OG0002481	2	1	1	1	2	1	1	9
OG0002482	5	1	1	1	0	1	0	9
OG0002483	3	1	1	1	1	1	1	9
OG0002484	2	1	1	1	2	1	1	9
OG0002485	2	1	1	1	1	2	1	9
OG0002486	2	1	1	2	1	1	1	9
OG0002487	2	1	1	2	1	1	1	9
OG0002488	2	1	1	1	2	1	1	9
OG0002489	2	1	1	1	2	0	2	9
OG0002490	2	1	1	1	2	1	1	9
OG0002491	2	1	1	1	1	1	2	9
OG0002492	2	1	1	1	2	1	1	9
OG0002493	2	1	1	1	2	1	1	9
OG0002494	2	1	1	1	0	1	3	9
OG0002495	2	1	1	1	2	1	1	9
OG0002496	3	1	1	1	1	1	1	9
OG0002497	2	1	1	1	2	1	1	9
OG0002498	3	1	1	1	1	1	1	9
OG0002499	2	1	1	1	1	2	1	9
OG0002500	2	0	0	0	1	1	5	9
OG0002501	2	1	1	1	2	1	1	9
OG0002502	3	1	1	1	1	1	1	9
OG0002503	2	1	1	1	1	1	2	9
OG0002504	2	1	1	1	2	1	1	9
OG0002505	3	1	1	1	1	1	1	9
OG0002506	2	0	1	0	2	1	3	9
OG0002507	2	1	1	1	1	1	2	9
OG0002508	3	1	1	1	1	1	1	9
OG0002509	2	1	1	2	1	1	1	9
OG0002510	2	1	1	2	1	1	1	9
OG0002511	2	1	1	1	2	1	1	9
OG0002512	2	1	1	1	2	1	1	9
OG0002513	2	1	1	1	2	1	1	9
OG0002514	2	1	2	1	1	1	1	9
OG0002515	2	2	1	1	1	1	1	9
OG0002516	2	1	1	1	2	1	1	9
OG0002517	2	1	1	1	2	1	1	9
OG0002518	2	1	1	1	1	1	2	9
OG0002519	3	1	1	1	1	1	1	9
OG0002520	3	1	1	1	1	1	1	9
OG0002521	2	1	1	1	1	1	2	9
OG0002522	2	1	1	1	2	1	1	9
OG0002523	2	1	1	1	2	1	1	9
OG0002524	2	1	1	1	2	1	1	9
OG0002525	2	1	1	2	1	1	1	9
OG0002526	2	1	2	1	1	1	1	9
OG0002527	2	1	1	1	1	2	1	9
OG0002528	2	1	1	1	2	1	1	9
OG0002529	3	1	1	1	1	1	1	9
OG0002530	2	1	1	1	1	1	2	9
OG0002531	2	1	1	1	0	1	3	9
OG0002532	2	1	1	1	1	1	2	9
OG0002533	2	1	1	1	2	1	1	9
OG0002534	3	1	1	1	1	1	1	9
OG0002535	2	1	1	1	1	1	2	9
OG0002536	3	1	1	1	1	1	1	9
OG0002537	3	1	1	1	1	1	1	9
OG0002538	2	1	1	1	1	1	2	9
OG0002539	2	0	0	7	0	0	0	9
OG0002540	1	2	1	1	1	1	2	9
OG0002541	1	1	1	1	2	1	2	9
OG0002542	2	1	1	1	2	1	1	9
OG0002543	3	1	1	1	1	1	1	9
OG0002544	2	1	1	1	2	1	1	9
OG0002545	2	1	1	1	0	4	0	9
OG0002546	3	1	1	1	1	1	1	9
OG0002547	2	0	1	1	2	1	2	9
OG0002548	3	1	1	1	1	1	1	9
OG0002549	3	2	0	1	1	1	1	9
OG0002550	2	1	1	1	1	1	2	9
OG0002551	3	1	1	1	1	1	1	9
OG0002552	2	1	1	1	2	1	1	9
OG0002553	2	1	1	1	2	1	1	9
OG0002554	2	1	1	1	1	1	2	9
OG0002555	3	1	1	1	1	1	1	9
OG0002556	2	1	1	1	1	2	1	9
OG0002557	3	1	2	1	0	1	1	9
OG0002558	2	1	1	1	1	1	2	9
OG0002559	2	1	1	1	2	1	1	9
OG0002560	3	1	2	1	0	1	1	9
OG0002561	3	1	1	1	1	1	1	9
OG0002562	2	1	1	1	2	1	1	9
OG0002563	2	1	1	2	1	1	1	9
OG0002564	2	1	1	1	1	2	1	9
OG0002565	2	1	1	1	2	1	1	9
OG0002566	3	1	1	1	1	1	1	9
OG0002567	3	1	1	1	1	1	1	9
OG0002568	2	2	1	1	1	1	1	9
OG0002569	2	1	1	1	2	1	1	9
OG0002570	2	1	1	1	2	1	1	9
OG0002571	2	1	1	1	1	1	2	9
OG0002572	2	1	1	1	2	1	1	9
OG0002573	2	1	1	1	2	1	1	9
OG0002574	2	1	1	1	1	1	2	9
OG0002575	2	1	1	2	1	1	1	9
OG0002576	3	1	1	1	1	1	1	9
OG0002577	4	1	1	1	0	1	1	9
OG0002578	2	1	1	1	1	1	2	9
OG0002579	9	0	0	0	0	0	0	9
OG0002580	2	1	1	1	2	1	1	9
OG0002581	2	1	1	1	1	2	1	9
OG0002582	2	1	1	1	1	2	1	9
OG0002583	5	1	1	1	0	1	0	9
OG0002584	2	1	1	1	2	1	1	9
OG0002585	2	2	1	1	1	1	1	9
OG0002586	2	1	1	1	2	1	1	9
OG0002587	2	1	1	1	1	2	1	9
OG0002588	2	1	1	1	1	1	2	9
OG0002589	2	1	1	1	1	1	2	9
OG0002590	2	0	1	2	1	1	2	9
OG0002591	2	1	1	2	1	1	1	9
OG0002592	3	1	1	1	1	1	1	9
OG0002593	3	1	1	1	1	1	1	9
OG0002594	3	1	2	2	0	1	0	9
OG0002595	3	1	1	1	0	1	2	9
OG0002596	2	1	1	1	1	1	2	9
OG0002597	2	1	1	1	1	1	2	9
OG0002598	2	1	1	1	1	1	2	9
OG0002599	3	1	1	1	1	1	1	9
OG0002600	3	1	1	1	1	1	1	9
OG0002601	4	1	1	1	0	1	1	9
OG0002602	2	1	1	1	2	1	1	9
OG0002603	1	1	1	1	1	1	3	9
OG0002604	5	1	1	1	0	1	0	9
OG0002605	4	1	2	1	0	1	0	9
OG0002606	2	1	1	1	2	1	1	9
OG0002607	2	1	1	1	2	1	1	9
OG0002608	2	1	2	1	1	1	1	9
OG0002609	2	1	1	1	0	1	3	9
OG0002610	2	1	1	1	1	1	2	9
OG0002611	2	1	1	1	1	1	2	9
OG0002612	2	1	1	1	1	1	2	9
OG0002613	2	1	2	2	0	1	1	9
OG0002614	2	1	1	1	1	1	2	9
OG0002615	2	1	1	1	1	2	1	9
OG0002616	2	1	1	1	1	1	2	9
OG0002617	2	1	1	1	1	1	2	9
OG0002618	2	1	1	1	2	1	1	9
OG0002619	2	1	1	1	1	1	2	9
OG0002620	2	2	1	1	0	3	0	9
OG0002621	3	1	1	1	1	1	1	9
OG0002622	2	1	1	1	2	1	1	9
OG0002623	2	1	1	1	2	1	1	9
OG0002624	2	1	1	1	1	1	2	9
OG0002625	2	1	1	1	1	1	2	9
OG0002626	2	1	1	1	2	1	1	9
OG0002627	2	1	1	1	2	1	1	9
OG0002628	2	1	1	1	2	1	1	9
OG0002629	4	1	2	1	0	1	0	9
OG0002630	5	1	1	1	0	1	0	9
OG0002631	2	1	1	0	1	1	3	9
OG0002632	3	1	1	1	1	1	1	9
OG0002633	2	0	0	1	0	2	4	9
OG0002634	2	1	1	1	1	1	2	9
OG0002635	2	1	1	1	2	1	1	9
OG0002636	2	1	1	1	1	1	2	9
OG0002637	2	1	1	1	1	1	2	9
OG0002638	2	1	1	1	1	2	1	9
OG0002639	2	1	1	1	2	1	1	9
OG0002640	2	1	1	1	2	1	1	9
OG0002641	3	1	1	1	1	1	1	9
OG0002642	2	3	1	1	0	1	1	9
OG0002643	2	1	1	1	1	1	2	9
OG0002644	2	1	1	1	1	2	1	9
OG0002645	2	1	1	1	2	1	1	9
OG0002646	1	1	1	1	1	1	3	9
OG0002647	3	1	1	1	1	1	1	9
OG0002648	2	1	1	1	2	1	1	9
OG0002649	1	1	1	1	2	1	2	9
OG0002650	2	1	2	1	0	2	1	9
OG0002651	1	1	1	1	3	1	1	9
OG0002652	1	1	1	1	3	1	1	9
OG0002653	2	1	1	1	1	1	2	9
OG0002654	2	1	1	1	2	1	1	9
OG0002655	2	1	1	1	2	1	1	9
OG0002656	2	1	1	1	1	2	1	9
OG0002657	2	1	1	2	1	1	1	9
OG0002658	2	1	1	1	2	1	1	9
OG0002659	2	1	1	1	1	2	1	9
OG0002660	2	1	2	1	1	1	1	9
OG0002661	2	1	1	1	1	2	1	9
OG0002662	2	1	1	1	2	1	1	9
OG0002663	3	1	1	1	1	1	1	9
OG0002664	3	1	1	1	1	1	1	9
OG0002665	4	1	1	1	0	1	1	9
OG0002666	2	1	1	1	2	1	1	9
OG0002667	2	1	1	2	1	1	1	9
OG0002668	3	1	1	1	1	1	1	9
OG0002669	2	1	1	1	2	1	1	9
OG0002670	2	1	1	2	1	1	1	9
OG0002671	2	1	1	1	3	0	1	9
OG0002672	2	1	1	1	1	0	3	9
OG0002673	3	1	1	1	1	1	1	9
OG0002674	1	1	1	1	2	1	2	9
OG0002675	1	1	1	1	1	1	3	9
OG0002676	1	1	1	1	1	1	3	9
OG0002677	2	1	1	1	2	1	1	9
OG0002678	1	1	1	1	2	2	1	9
OG0002679	2	1	1	1	2	1	1	9
OG0002680	3	1	1	1	1	1	1	9
OG0002681	3	1	1	1	1	1	1	9
OG0002682	4	1	1	1	1	0	1	9
OG0002683	2	1	2	4	0	0	0	9
OG0002684	2	1	1	1	2	1	1	9
OG0002685	2	1	1	1	1	1	2	9
OG0002686	2	1	1	1	2	1	1	9
OG0002687	4	1	1	0	2	1	0	9
OG0002688	3	1	1	1	1	1	1	9
OG0002689	2	1	1	1	2	1	1	9
OG0002690	2	1	1	1	2	1	1	9
OG0002691	2	1	1	2	1	1	1	9
OG0002692	2	1	1	2	1	1	1	9
OG0002693	2	1	1	1	2	1	1	9
OG0002694	2	1	1	3	0	1	1	9
OG0002695	3	1	1	1	1	1	1	9
OG0002696	1	1	1	2	2	1	1	9
OG0002697	2	1	2	1	1	1	1	9
OG0002698	3	1	1	1	1	1	1	9
OG0002699	3	1	1	1	1	1	1	9
OG0002700	1	1	1	1	1	1	3	9
OG0002701	2	1	1	1	1	1	2	9
OG0002702	2	1	1	1	1	1	2	9
OG0002703	2	1	1	1	2	1	1	9
OG0002704	2	1	1	1	3	0	1	9
OG0002705	2	1	1	1	1	2	1	9
OG0002706	2	2	1	1	1	1	1	9
OG0002707	2	1	1	2	1	1	1	9
OG0002708	2	1	1	1	2	1	1	9
OG0002709	3	1	1	1	1	1	1	9
OG0002710	3	1	1	1	1	1	1	9
OG0002711	5	1	2	1	0	0	0	9
OG0002712	2	0	1	1	1	1	3	9
OG0002713	3	1	1	1	1	1	1	9
OG0002714	1	2	1	1	1	2	1	9
OG0002715	3	1	1	1	1	1	1	9
OG0002716	2	0	1	4	0	2	0	9
OG0002717	2	1	1	1	1	2	1	9
OG0002718	2	1	1	1	1	1	2	9
OG0002719	1	1	3	1	1	1	1	9
OG0002720	2	1	1	0	1	1	3	9
OG0002721	2	1	1	1	2	1	1	9
OG0002722	4	1	1	2	0	1	0	9
OG0002723	2	1	1	1	2	1	1	9
OG0002724	2	1	1	2	1	1	1	9
OG0002725	2	1	1	1	2	1	1	9
OG0002726	2	1	1	1	1	2	1	9
OG0002727	2	1	1	1	1	1	2	9
OG0002728	2	1	0	1	2	1	2	9
OG0002729	2	1	1	1	2	1	1	9
OG0002730	3	1	1	1	1	1	1	9
OG0002731	3	1	1	1	1	1	1	9
OG0002732	3	1	1	1	1	1	1	9
OG0002733	2	1	1	1	1	1	2	9
OG0002734	2	1	1	1	1	1	2	9
OG0002735	2	1	1	1	0	1	3	9
OG0002736	3	1	1	1	2	0	1	9
OG0002737	1	1	1	1	3	1	1	9
OG0002738	2	1	1	2	1	1	1	9
OG0002739	2	1	0	1	2	0	3	9
OG0002740	4	1	1	1	0	2	0	9
OG0002741	2	1	1	1	2	1	1	9
OG0002742	2	1	2	1	1	1	1	9
OG0002743	1	1	1	1	1	4	0	9
OG0002744	2	1	1	1	0	1	3	9
OG0002745	2	1	1	1	2	1	1	9
OG0002746	2	1	1	1	2	1	1	9
OG0002747	3	2	1	1	1	1	0	9
OG0002748	3	1	1	1	1	1	1	9
OG0002749	2	1	1	1	2	1	1	9
OG0002750	2	1	1	1	2	1	1	9
OG0002751	1	1	1	1	1	1	3	9
OG0002752	2	1	1	1	1	2	1	9
OG0002753	3	1	1	1	1	1	1	9
OG0002754	2	1	1	1	2	1	1	9
OG0002755	2	1	1	1	2	1	1	9
OG0002756	2	1	1	1	2	1	1	9
OG0002757	2	1	1	1	2	1	1	9
OG0002758	1	1	1	1	2	1	2	9
OG0002759	1	1	1	2	2	1	1	9
OG0002760	1	1	1	1	2	1	2	9
OG0002761	2	0	1	0	3	1	2	9
OG0002762	2	1	1	1	2	1	1	9
OG0002763	2	1	1	1	1	1	2	9
OG0002764	2	1	1	1	2	1	1	9
OG0002765	2	1	1	1	2	1	1	9
OG0002766	1	2	1	1	2	1	1	9
OG0002767	2	1	1	1	1	2	1	9
OG0002768	2	1	1	1	1	1	2	9
OG0002769	2	1	1	1	1	2	1	9
OG0002770	4	1	2	1	0	1	0	9
OG0002771	2	1	1	1	2	1	1	9
OG0002772	2	1	1	1	1	1	2	9
OG0002773	3	1	1	1	2	1	0	9
OG0002774	2	1	1	1	1	1	2	9
OG0002775	3	1	1	1	1	1	1	9
OG0002776	2	2	1	1	1	1	1	9
OG0002777	2	1	1	1	2	1	1	9
OG0002778	3	1	0	2	0	2	1	9
OG0002779	3	1	1	1	1	1	1	9
OG0002780	2	1	1	1	2	1	1	9
OG0002781	2	1	1	1	1	1	2	9
OG0002782	2	1	1	1	1	1	2	9
OG0002783	3	1	1	1	1	1	1	9
OG0002784	3	1	1	1	1	1	1	9
OG0002785	1	1	1	2	2	1	1	9
OG0002786	2	1	1	1	2	1	1	9
OG0002787	2	1	1	1	2	1	1	9
OG0002788	1	1	2	1	2	1	1	9
OG0002789	1	1	1	1	2	1	2	9
OG0002790	1	1	1	1	2	1	2	9
OG0002791	2	1	1	1	2	1	1	9
OG0002792	1	1	1	1	1	1	3	9
OG0002793	3	1	1	1	1	1	1	9
OG0002794	2	1	1	1	2	1	1	9
OG0002795	2	1	1	1	2	1	1	9
OG0002796	2	1	1	1	1	1	2	9
OG0002797	2	1	1	1	2	1	1	9
OG0002798	2	1	1	2	1	1	1	9
OG0002799	2	1	1	1	2	1	1	9
OG0002800	3	1	1	1	1	1	1	9
OG0002801	3	1	1	1	1	1	1	9
OG0002802	3	1	1	1	1	1	1	9
OG0002803	2	1	1	1	2	1	1	9
OG0002804	4	1	1	0	1	1	1	9
OG0002805	2	1	1	1	1	2	1	9
OG0002806	3	1	1	1	0	2	1	9
OG0002807	2	1	1	1	2	1	1	9
OG0002808	2	1	1	1	2	1	1	9
OG0002809	1	2	1	1	2	1	1	9
OG0002810	3	1	1	1	0	3	0	9
OG0002811	2	1	1	2	1	1	1	9
OG0002812	1	1	1	2	1	1	2	9
OG0002813	1	1	1	1	2	1	2	9
OG0002814	1	1	1	1	1	1	3	9
OG0002815	1	1	1	1	1	1	3	9
OG0002816	9	0	0	0	0	0	0	9
OG0002817	1	1	1	2	1	1	2	9
OG0002818	1	1	1	1	1	1	3	9
OG0002819	1	1	0	1	2	1	3	9
OG0002820	3	0	1	2	1	1	1	9
OG0002821	2	1	1	1	1	1	2	9
OG0002822	2	1	1	2	1	1	1	9
OG0002823	2	1	1	1	1	2	1	9
OG0002824	2	1	1	1	2	1	1	9
OG0002825	2	2	1	1	1	1	1	9
OG0002826	4	1	1	2	0	0	1	9
OG0002827	2	1	1	1	2	1	1	9
OG0002828	2	2	1	1	1	1	1	9
OG0002829	2	1	1	1	1	2	1	9
OG0002830	5	1	1	1	0	1	0	9
OG0002831	2	1	1	1	0	4	0	9
OG0002832	3	1	1	1	1	1	1	9
OG0002833	2	1	1	1	2	1	1	9
OG0002834	2	1	1	1	1	2	1	9
OG0002835	3	1	1	1	1	1	1	9
OG0002836	2	1	1	1	1	1	2	9
OG0002837	2	1	1	1	1	1	2	9
OG0002838	3	1	1	1	1	1	1	9
OG0002839	2	1	1	1	2	1	1	9
OG0002840	2	1	1	1	1	1	2	9
OG0002841	2	1	1	1	2	1	1	9
OG0002842	2	1	1	1	2	1	1	9
OG0002843	2	1	1	1	2	1	1	9
OG0002844	2	1	1	1	2	1	1	9
OG0002845	3	1	1	1	1	1	1	9
OG0002846	2	1	1	1	1	1	2	9
OG0002847	2	1	1	1	1	2	1	9
OG0002848	2	1	1	1	2	1	1	9
OG0002849	2	1	1	1	2	1	1	9
OG0002850	2	1	1	1	2	1	1	9
OG0002851	2	1	1	1	2	1	1	9
OG0002852	3	0	1	0	3	1	1	9
OG0002853	2	1	2	1	1	0	2	9
OG0002854	2	1	1	1	1	1	2	9
OG0002855	2	1	1	1	2	1	1	9
OG0002856	3	1	1	1	1	1	1	9
OG0002857	2	1	1	1	2	1	1	9
OG0002858	3	2	1	1	0	1	1	9
OG0002859	2	1	1	1	2	1	1	9
OG0002860	2	1	1	1	2	1	1	9
OG0002861	2	1	1	1	1	1	2	9
OG0002862	2	1	1	1	2	1	1	9
OG0002863	3	1	1	1	1	1	1	9
OG0002864	2	1	1	1	1	1	2	9
OG0002865	3	1	1	1	1	1	1	9
OG0002866	2	1	1	1	1	1	2	9
OG0002867	2	1	1	2	1	1	1	9
OG0002868	2	1	1	1	1	2	1	9
OG0002869	4	1	0	1	1	1	1	9
OG0002870	3	1	1	1	1	1	1	9
OG0002871	2	1	1	1	2	1	1	9
OG0002872	2	1	1	1	2	1	1	9
OG0002873	2	1	1	2	1	1	1	9
OG0002874	2	1	1	1	1	1	2	9
OG0002875	1	1	1	1	1	2	2	9
OG0002876	1	1	1	1	1	1	3	9
OG0002877	5	1	1	1	0	1	0	9
OG0002878	2	1	1	1	3	1	0	9
OG0002879	2	1	1	1	2	1	1	9
OG0002880	2	1	1	1	1	2	1	9
OG0002881	1	1	1	1	2	1	2	9
OG0002882	5	1	1	1	0	1	0	9
OG0002883	2	1	1	1	2	1	1	9
OG0002884	2	1	1	1	2	1	1	9
OG0002885	2	1	1	1	2	1	1	9
OG0002886	1	1	1	1	1	1	3	9
OG0002887	3	3	1	1	0	1	0	9
OG0002888	1	1	1	1	3	1	1	9
OG0002889	4	2	1	2	0	0	0	9
OG0002890	2	1	1	1	2	1	1	9
OG0002891	2	1	1	1	1	1	2	9
OG0002892	2	1	2	3	0	1	0	9
OG0002893	2	1	1	2	1	1	1	9
OG0002894	3	1	1	1	1	1	1	9
OG0002895	2	1	1	1	1	2	1	9
OG0002896	9	0	0	0	0	0	0	9
OG0002897	3	1	1	1	1	1	1	9
OG0002898	2	1	1	2	1	1	1	9
OG0002899	3	1	1	1	1	1	1	9
OG0002900	2	1	1	1	1	1	2	9
OG0002901	2	1	2	1	1	1	1	9
OG0002902	3	1	1	1	1	1	1	9
OG0002903	3	1	1	1	1	1	1	9
OG0002904	2	1	0	1	2	2	1	9
OG0002905	3	1	1	1	1	1	1	9
OG0002906	2	1	1	1	1	2	1	9
OG0002907	2	1	1	1	2	1	1	9
OG0002908	2	1	1	1	2	1	1	9
OG0002909	2	1	1	1	1	2	1	9
OG0002910	2	1	1	1	2	1	1	9
OG0002911	2	1	1	2	1	1	1	9
OG0002912	3	1	1	1	1	1	1	9
OG0002913	2	1	1	2	0	3	0	9
OG0002914	1	1	2	4	0	1	0	9
OG0002915	1	1	1	1	1	1	3	9
OG0002916	1	1	1	1	2	1	2	9
OG0002917	1	1	1	1	1	2	2	9
OG0002918	2	1	1	1	1	2	1	9
OG0002919	2	1	1	1	1	2	1	9
OG0002920	2	1	2	1	1	1	1	9
OG0002921	2	1	1	1	2	1	1	9
OG0002922	2	1	1	1	1	2	1	9
OG0002923	1	1	1	1	1	1	3	9
OG0002924	1	1	1	1	2	2	1	9
OG0002925	1	1	1	1	1	3	1	9
OG0002926	2	1	1	1	2	1	1	9
OG0002927	2	1	1	1	2	0	2	9
OG0002928	2	1	1	1	2	1	1	9
OG0002929	3	1	1	1	1	1	1	9
OG0002930	2	1	1	1	1	2	1	9
OG0002931	4	1	1	1	0	2	0	9
OG0002932	2	1	1	1	2	1	1	9
OG0002933	2	1	1	2	1	1	1	9
OG0002934	3	1	1	1	1	1	1	9
OG0002935	2	1	2	1	1	1	1	9
OG0002936	1	1	1	1	2	2	1	9
OG0002937	1	1	1	1	1	1	3	9
OG0002938	1	1	1	1	1	1	3	9
OG0002939	1	1	1	1	2	1	2	9
OG0002940	1	1	2	1	2	1	1	9
OG0002941	0	9	0	0	0	0	0	9
OG0002942	0	7	0	2	0	0	0	9
OG0002943	0	1	0	8	0	0	0	9
OG0002944	0	9	0	0	0	0	0	9
OG0002945	0	3	4	2	0	0	0	9
OG0002946	0	1	1	1	2	1	3	9
OG0002947	0	1	6	2	0	0	0	9
OG0002948	0	1	1	1	6	0	0	9
OG0002949	0	1	7	1	0	0	0	9
OG0002950	0	1	8	0	0	0	0	9
OG0002951	0	1	0	4	0	0	4	9
OG0002952	0	0	9	0	0	0	0	9
OG0002953	0	0	9	0	0	0	0	9
OG0002954	0	0	8	0	1	0	0	9
OG0002955	0	0	9	0	0	0	0	9
OG0002956	0	0	1	1	6	1	0	9
OG0002957	0	0	1	3	2	1	2	9
OG0002958	0	0	0	9	0	0	0	9
OG0002959	0	0	0	9	0	0	0	9
OG0002960	0	0	0	9	0	0	0	9
OG0002961	0	0	0	9	0	0	0	9
OG0002962	0	0	0	9	0	0	0	9
OG0002963	0	0	0	0	5	2	2	9
OG0002964	0	0	0	0	8	0	1	9
OG0002965	0	0	0	0	9	0	0	9
OG0002966	0	0	0	0	7	0	2	9
OG0002967	0	0	0	0	6	0	3	9
OG0002968	0	0	0	0	7	0	2	9
OG0002969	0	0	0	0	5	1	3	9
OG0002970	0	0	0	0	9	0	0	9
OG0002971	0	0	0	0	5	0	4	9
OG0002972	0	0	0	0	9	0	0	9
OG0002973	0	0	0	0	2	2	5	9
OG0002974	0	0	0	0	5	1	3	9
OG0002975	0	0	0	0	6	0	3	9
OG0002976	0	0	0	0	2	0	7	9
OG0002977	0	0	0	0	9	0	0	9
OG0002978	0	0	0	0	3	0	6	9
OG0002979	0	0	0	0	2	0	7	9
OG0002980	0	0	0	0	1	1	7	9
OG0002981	0	0	0	0	1	0	8	9
OG0002982	0	0	0	0	0	9	0	9
OG0002983	0	0	0	0	0	9	0	9
OG0002984	0	0	0	0	0	9	0	9
OG0002985	0	0	0	0	0	9	0	9
OG0002986	0	0	0	0	0	9	0	9
OG0002987	0	0	0	0	0	9	0	9
OG0002988	0	0	0	0	0	9	0	9
OG0002989	0	0	0	0	0	2	7	9
OG0002990	0	0	0	0	0	0	9	9
OG0002991	0	0	0	0	0	0	9	9
OG0002992	0	0	0	0	0	0	9	9
OG0002993	0	0	0	0	0	0	9	9
OG0002994	0	0	0	0	0	0	9	9
OG0002995	0	0	0	0	0	0	9	9
OG0002996	0	0	0	0	0	0	9	9
OG0002997	0	0	0	0	0	0	9	9
OG0002998	0	0	0	0	0	0	9	9
OG0002999	0	0	0	0	0	0	9	9
OG0003000	0	0	0	0	0	0	9	9
OG0003001	0	0	0	0	0	0	9	9
OG0003002	0	0	0	0	0	0	9	9
OG0003003	0	0	0	0	0	0	9	9
OG0003004	0	0	0	0	0	0	9	9
OG0003005	0	0	0	0	0	0	9	9
OG0003006	0	0	0	0	0	0	9	9
OG0003007	0	0	0	0	0	0	9	9
OG0003008	0	0	0	0	0	0	9	9
OG0003009	0	0	0	0	0	0	9	9
OG0003010	0	0	0	0	0	0	9	9
OG0003011	0	0	0	0	0	0	9	9
OG0003012	0	0	0	0	0	0	9	9
OG0003013	0	0	0	0	0	0	9	9
OG0003014	0	0	0	0	0	0	9	9
OG0003015	0	0	0	0	0	0	9	9
OG0003016	0	0	0	0	0	0	9	9
OG0003017	0	0	0	0	0	0	9	9
OG0003018	0	0	0	0	0	0	9	9
OG0003019	4	1	1	1	0	1	0	8
OG0003020	2	1	1	3	0	1	0	8
OG0003021	4	1	1	2	0	0	0	8
OG0003022	8	0	0	0	0	0	0	8
OG0003023	5	1	1	0	0	1	0	8
OG0003024	2	1	1	1	1	1	1	8
OG0003025	2	1	1	1	1	1	1	8
OG0003026	2	1	1	1	1	1	1	8
OG0003027	2	1	1	1	1	1	1	8
OG0003028	2	1	1	1	1	1	1	8
OG0003029	2	1	1	1	1	1	1	8
OG0003030	2	1	1	1	1	1	1	8
OG0003031	2	1	1	1	1	1	1	8
OG0003032	2	1	1	1	1	1	1	8
OG0003033	2	1	1	1	1	1	1	8
OG0003034	2	1	1	1	1	1	1	8
OG0003035	2	2	1	2	0	1	0	8
OG0003036	4	1	1	1	0	1	0	8
OG0003037	2	1	1	1	1	1	1	8
OG0003038	2	1	1	1	0	1	2	8
OG0003039	2	1	1	1	1	1	1	8
OG0003040	2	1	1	1	1	1	1	8
OG0003041	2	1	1	1	0	1	2	8
OG0003042	2	1	1	1	1	1	1	8
OG0003043	2	1	1	1	1	1	1	8
OG0003044	2	1	1	1	1	1	1	8
OG0003045	2	1	1	1	1	1	1	8
OG0003046	2	1	1	1	1	2	0	8
OG0003047	2	1	1	1	1	1	1	8
OG0003048	6	1	1	0	0	0	0	8
OG0003049	2	1	1	1	1	1	1	8
OG0003050	3	1	1	1	0	1	1	8
OG0003051	2	1	1	1	1	1	1	8
OG0003052	2	1	1	1	1	1	1	8
OG0003053	5	1	0	1	0	0	1	8
OG0003054	2	1	1	1	1	1	1	8
OG0003055	2	1	1	1	1	1	1	8
OG0003056	2	1	1	1	1	1	1	8
OG0003057	2	1	1	1	1	1	1	8
OG0003058	2	1	1	1	1	1	1	8
OG0003059	2	1	1	1	1	1	1	8
OG0003060	2	1	1	1	1	1	1	8
OG0003061	2	1	1	1	1	1	1	8
OG0003062	2	1	1	1	1	1	1	8
OG0003063	2	1	1	1	1	1	1	8
OG0003064	2	1	1	1	1	1	1	8
OG0003065	2	1	1	1	1	1	1	8
OG0003066	3	1	1	1	0	1	1	8
OG0003067	2	1	1	1	1	1	1	8
OG0003068	2	1	2	2	0	1	0	8
OG0003069	2	1	1	1	1	1	1	8
OG0003070	2	1	1	1	1	1	1	8
OG0003071	2	1	1	1	1	1	1	8
OG0003072	2	1	1	1	1	1	1	8
OG0003073	2	1	1	1	1	1	1	8
OG0003074	2	1	0	1	2	1	1	8
OG0003075	4	1	0	2	0	1	0	8
OG0003076	2	1	1	1	1	1	1	8
OG0003077	2	1	1	1	1	1	1	8
OG0003078	2	1	1	1	1	1	1	8
OG0003079	2	1	1	1	0	1	2	8
OG0003080	2	1	1	1	1	1	1	8
OG0003081	2	1	1	1	1	1	1	8
OG0003082	2	1	1	1	1	1	1	8
OG0003083	2	1	1	1	1	1	1	8
OG0003084	2	1	1	1	1	1	1	8
OG0003085	2	1	1	1	1	1	1	8
OG0003086	2	1	1	1	2	1	0	8
OG0003087	2	2	1	1	1	0	1	8
OG0003088	2	1	1	1	2	0	1	8
OG0003089	2	3	1	1	1	0	0	8
OG0003090	2	1	1	1	1	1	1	8
OG0003091	2	1	1	1	1	1	1	8
OG0003092	2	1	4	1	0	0	0	8
OG0003093	2	1	1	1	1	1	1	8
OG0003094	2	1	1	1	1	1	1	8
OG0003095	2	1	1	1	1	1	1	8
OG0003096	2	1	1	1	1	1	1	8
OG0003097	2	1	1	1	1	1	1	8
OG0003098	2	1	1	1	1	1	1	8
OG0003099	3	1	1	1	1	1	0	8
OG0003100	2	1	1	1	1	1	1	8
OG0003101	2	1	1	1	1	1	1	8
OG0003102	2	1	1	1	1	1	1	8
OG0003103	2	1	1	1	1	1	1	8
OG0003104	3	1	1	1	1	0	1	8
OG0003105	2	1	2	1	1	0	1	8
OG0003106	2	1	1	1	1	1	1	8
OG0003107	5	1	1	1	0	0	0	8
OG0003108	2	1	1	1	1	1	1	8
OG0003109	2	1	1	1	1	1	1	8
OG0003110	4	1	2	1	0	0	0	8
OG0003111	3	1	1	1	0	1	1	8
OG0003112	2	1	1	1	1	1	1	8
OG0003113	2	1	1	1	0	2	1	8
OG0003114	2	1	1	1	1	1	1	8
OG0003115	2	1	1	1	1	1	1	8
OG0003116	2	1	1	1	1	1	1	8
OG0003117	2	1	1	1	1	1	1	8
OG0003118	2	1	1	1	1	1	1	8
OG0003119	2	1	1	1	1	1	1	8
OG0003120	2	1	1	1	0	1	2	8
OG0003121	2	1	1	1	1	1	1	8
OG0003122	2	1	1	1	1	1	1	8
OG0003123	2	1	1	1	1	1	1	8
OG0003124	2	1	1	1	1	1	1	8
OG0003125	2	1	1	1	1	1	1	8
OG0003126	2	1	1	1	1	1	1	8
OG0003127	2	1	1	1	1	1	1	8
OG0003128	2	1	1	1	1	1	1	8
OG0003129	2	1	1	1	1	1	1	8
OG0003130	2	1	1	1	1	1	1	8
OG0003131	2	1	1	1	1	1	1	8
OG0003132	2	1	1	1	1	1	1	8
OG0003133	2	1	1	1	1	1	1	8
OG0003134	2	1	1	1	1	1	1	8
OG0003135	2	1	1	1	1	1	1	8
OG0003136	2	1	1	1	1	1	1	8
OG0003137	2	1	1	1	1	1	1	8
OG0003138	2	1	1	1	1	1	1	8
OG0003139	2	1	3	1	0	1	0	8
OG0003140	2	1	1	1	1	1	1	8
OG0003141	4	1	1	1	0	1	0	8
OG0003142	2	1	1	1	1	1	1	8
OG0003143	4	1	1	1	0	1	0	8
OG0003144	2	1	1	1	1	1	1	8
OG0003145	2	1	1	1	1	1	1	8
OG0003146	2	1	1	1	1	1	1	8
OG0003147	2	1	1	1	1	1	1	8
OG0003148	2	1	1	1	1	0	2	8
OG0003149	2	1	1	1	1	1	1	8
OG0003150	2	1	1	1	1	1	1	8
OG0003151	2	1	1	1	1	2	0	8
OG0003152	2	1	1	1	1	1	1	8
OG0003153	2	1	1	1	1	1	1	8
OG0003154	2	1	1	1	1	1	1	8
OG0003155	2	1	1	1	1	1	1	8
OG0003156	2	1	1	1	0	1	2	8
OG0003157	2	1	1	1	1	1	1	8
OG0003158	2	1	1	1	1	1	1	8
OG0003159	2	1	1	1	1	1	1	8
OG0003160	2	1	1	1	1	0	2	8
OG0003161	2	1	1	1	1	1	1	8
OG0003162	2	1	1	1	1	1	1	8
OG0003163	2	1	1	1	1	1	1	8
OG0003164	4	1	2	1	0	0	0	8
OG0003165	2	1	1	1	1	1	1	8
OG0003166	2	1	1	1	1	1	1	8
OG0003167	2	1	1	1	1	1	1	8
OG0003168	2	1	1	1	1	1	1	8
OG0003169	1	1	1	1	1	1	2	8
OG0003170	2	1	1	1	1	1	1	8
OG0003171	2	1	1	1	1	1	1	8
OG0003172	2	1	1	1	1	1	1	8
OG0003173	2	1	1	1	1	1	1	8
OG0003174	2	1	1	1	1	1	1	8
OG0003175	2	1	0	1	1	1	2	8
OG0003176	4	1	1	1	0	1	0	8
OG0003177	2	1	1	1	1	1	1	8
OG0003178	2	1	1	1	1	1	1	8
OG0003179	2	1	1	1	1	1	1	8
OG0003180	2	1	1	1	1	1	1	8
OG0003181	2	1	1	1	1	1	1	8
OG0003182	2	1	1	1	1	1	1	8
OG0003183	2	1	1	1	1	1	1	8
OG0003184	2	1	1	1	1	1	1	8
OG0003185	1	1	1	1	1	1	2	8
OG0003186	2	1	1	1	1	1	1	8
OG0003187	2	1	1	1	1	1	1	8
OG0003188	3	1	1	2	0	1	0	8
OG0003189	2	1	1	1	1	1	1	8
OG0003190	2	1	1	1	1	1	1	8
OG0003191	2	1	1	1	1	1	1	8
OG0003192	2	1	1	1	1	1	1	8
OG0003193	2	1	1	1	1	1	1	8
OG0003194	2	1	1	1	1	1	1	8
OG0003195	2	1	1	1	1	1	1	8
OG0003196	2	1	1	1	1	1	1	8
OG0003197	2	1	1	1	1	1	1	8
OG0003198	2	1	1	1	0	2	1	8
OG0003199	2	1	1	1	1	1	1	8
OG0003200	2	1	1	3	0	1	0	8
OG0003201	2	1	1	1	1	1	1	8
OG0003202	2	1	1	1	1	1	1	8
OG0003203	2	1	1	1	1	1	1	8
OG0003204	2	1	1	1	1	1	1	8
OG0003205	4	1	1	1	1	0	0	8
OG0003206	2	1	1	1	1	1	1	8
OG0003207	2	1	1	1	1	1	1	8
OG0003208	2	1	1	1	1	1	1	8
OG0003209	2	1	1	1	1	1	1	8
OG0003210	2	1	1	1	1	1	1	8
OG0003211	2	1	1	1	1	1	1	8
OG0003212	2	1	1	1	1	1	1	8
OG0003213	2	1	1	1	1	1	1	8
OG0003214	2	1	1	1	1	1	1	8
OG0003215	2	1	1	1	1	1	1	8
OG0003216	2	1	1	1	1	1	1	8
OG0003217	2	1	1	1	1	1	1	8
OG0003218	2	1	1	1	1	1	1	8
OG0003219	2	1	1	1	1	2	0	8
OG0003220	3	2	3	0	0	0	0	8
OG0003221	2	1	1	1	1	1	1	8
OG0003222	1	1	3	1	0	1	1	8
OG0003223	3	1	1	1	0	1	1	8
OG0003224	1	1	1	1	1	1	2	8
OG0003225	2	1	1	1	1	1	1	8
OG0003226	2	1	1	1	1	1	1	8
OG0003227	8	0	0	0	0	0	0	8
OG0003228	2	1	1	1	1	1	1	8
OG0003229	2	1	1	1	1	1	1	8
OG0003230	2	1	1	1	1	1	1	8
OG0003231	2	1	1	1	1	1	1	8
OG0003232	3	1	1	2	0	1	0	8
OG0003233	2	1	1	1	1	1	1	8
OG0003234	2	1	1	1	1	1	1	8
OG0003235	2	1	1	1	1	1	1	8
OG0003236	2	1	1	1	1	1	1	8
OG0003237	2	1	1	1	1	1	1	8
OG0003238	2	1	1	1	1	1	1	8
OG0003239	2	1	1	1	1	1	1	8
OG0003240	2	1	1	1	1	1	1	8
OG0003241	2	1	1	1	1	1	1	8
OG0003242	2	1	1	1	1	1	1	8
OG0003243	2	1	0	0	1	3	1	8
OG0003244	2	1	1	1	1	1	1	8
OG0003245	2	1	1	1	1	1	1	8
OG0003246	3	1	1	1	0	1	1	8
OG0003247	3	2	1	2	0	0	0	8
OG0003248	2	1	1	0	0	1	3	8
OG0003249	2	1	1	1	1	1	1	8
OG0003250	2	1	1	1	1	1	1	8
OG0003251	2	1	1	1	1	1	1	8
OG0003252	2	0	0	0	1	1	4	8
OG0003253	2	1	1	1	1	1	1	8
OG0003254	2	1	1	1	2	0	1	8
OG0003255	2	1	1	1	0	1	2	8
OG0003256	2	1	1	1	1	1	1	8
OG0003257	2	1	1	1	1	1	1	8
OG0003258	5	1	1	1	0	0	0	8
OG0003259	1	1	1	1	2	0	2	8
OG0003260	1	5	1	1	0	0	0	8
OG0003261	4	0	1	1	0	2	0	8
OG0003262	2	1	1	1	1	1	1	8
OG0003263	2	1	1	1	1	1	1	8
OG0003264	4	1	1	1	0	1	0	8
OG0003265	2	1	1	1	1	1	1	8
OG0003266	2	1	1	1	1	1	1	8
OG0003267	2	1	1	1	0	2	1	8
OG0003268	2	1	1	1	1	1	1	8
OG0003269	2	1	1	1	1	1	1	8
OG0003270	2	1	1	1	1	1	1	8
OG0003271	2	1	1	1	1	1	1	8
OG0003272	1	1	1	1	0	4	0	8
OG0003273	2	1	1	1	1	1	1	8
OG0003274	2	1	1	0	1	1	2	8
OG0003275	2	1	1	1	1	1	1	8
OG0003276	2	1	1	1	1	1	1	8
OG0003277	2	1	1	1	1	1	1	8
OG0003278	2	1	1	1	1	1	1	8
OG0003279	2	1	1	1	1	1	1	8
OG0003280	2	1	1	1	1	1	1	8
OG0003281	2	0	1	5	0	0	0	8
OG0003282	2	1	1	1	1	1	1	8
OG0003283	2	1	1	1	1	1	1	8
OG0003284	2	1	1	1	1	1	1	8
OG0003285	8	0	0	0	0	0	0	8
OG0003286	2	1	1	1	1	1	1	8
OG0003287	3	1	1	1	0	1	1	8
OG0003288	2	1	1	1	1	1	1	8
OG0003289	2	1	1	1	1	1	1	8
OG0003290	2	1	1	1	1	1	1	8
OG0003291	2	1	1	1	1	1	1	8
OG0003292	2	1	1	2	1	1	0	8
OG0003293	2	1	1	1	1	1	1	8
OG0003294	2	1	1	1	1	1	1	8
OG0003295	2	1	1	1	1	1	1	8
OG0003296	2	1	1	1	1	1	1	8
OG0003297	2	1	1	1	1	1	1	8
OG0003298	2	1	1	1	1	1	1	8
OG0003299	2	1	1	1	1	1	1	8
OG0003300	2	1	1	1	1	1	1	8
OG0003301	3	1	0	1	0	2	1	8
OG0003302	2	1	1	1	1	1	1	8
OG0003303	2	1	1	1	1	1	1	8
OG0003304	2	1	1	1	1	1	1	8
OG0003305	3	1	1	1	0	1	1	8
OG0003306	2	1	1	1	1	1	1	8
OG0003307	2	1	1	1	1	1	1	8
OG0003308	2	1	1	1	1	1	1	8
OG0003309	2	1	1	1	1	1	1	8
OG0003310	2	1	1	1	1	1	1	8
OG0003311	2	1	1	1	1	1	1	8
OG0003312	2	1	1	1	1	1	1	8
OG0003313	2	1	1	1	1	1	1	8
OG0003314	3	1	1	1	1	0	1	8
OG0003315	2	1	1	1	1	1	1	8
OG0003316	2	1	1	1	1	1	1	8
OG0003317	2	1	1	1	1	1	1	8
OG0003318	2	1	1	1	1	1	1	8
OG0003319	5	1	0	2	0	0	0	8
OG0003320	2	1	1	1	1	1	1	8
OG0003321	2	1	1	1	1	1	1	8
OG0003322	2	1	1	1	1	1	1	8
OG0003323	2	1	1	1	1	1	1	8
OG0003324	2	1	0	1	2	1	1	8
OG0003325	2	1	1	1	1	1	1	8
OG0003326	2	1	1	1	1	1	1	8
OG0003327	2	1	1	1	1	1	1	8
OG0003328	2	1	1	1	1	1	1	8
OG0003329	2	0	0	2	2	0	2	8
OG0003330	3	1	1	1	1	0	1	8
OG0003331	2	1	1	1	1	1	1	8
OG0003332	2	1	1	1	1	1	1	8
OG0003333	2	1	1	1	1	1	1	8
OG0003334	2	1	1	1	1	1	1	8
OG0003335	2	1	1	1	1	1	1	8
OG0003336	2	1	1	0	2	1	1	8
OG0003337	3	1	1	1	0	2	0	8
OG0003338	2	1	1	1	1	1	1	8
OG0003339	2	1	1	1	1	1	1	8
OG0003340	2	1	1	1	1	1	1	8
OG0003341	2	1	1	1	1	1	1	8
OG0003342	2	1	1	1	1	1	1	8
OG0003343	3	1	1	1	0	1	1	8
OG0003344	2	1	1	1	1	1	1	8
OG0003345	2	1	1	1	1	1	1	8
OG0003346	2	1	1	1	1	1	1	8
OG0003347	2	1	1	1	1	1	1	8
OG0003348	2	1	1	1	1	1	1	8
OG0003349	2	1	1	1	1	1	1	8
OG0003350	2	1	1	1	1	1	1	8
OG0003351	2	1	1	1	0	1	2	8
OG0003352	2	1	1	1	1	1	1	8
OG0003353	2	1	1	1	1	1	1	8
OG0003354	2	1	1	1	1	1	1	8
OG0003355	2	1	1	1	1	1	1	8
OG0003356	2	0	1	4	0	1	0	8
OG0003357	2	1	1	1	1	1	1	8
OG0003358	2	1	1	1	1	1	1	8
OG0003359	2	1	1	1	1	1	1	8
OG0003360	2	1	1	1	1	1	1	8
OG0003361	2	1	1	1	1	1	1	8
OG0003362	2	1	1	1	1	1	1	8
OG0003363	2	1	1	1	1	1	1	8
OG0003364	4	1	1	1	0	1	0	8
OG0003365	2	1	1	1	1	1	1	8
OG0003366	2	1	1	1	1	1	1	8
OG0003367	2	1	1	1	1	1	1	8
OG0003368	2	1	1	1	1	1	1	8
OG0003369	2	1	1	1	1	1	1	8
OG0003370	2	1	1	1	1	1	1	8
OG0003371	2	1	1	1	1	1	1	8
OG0003372	2	1	1	1	1	1	1	8
OG0003373	2	1	1	1	1	1	1	8
OG0003374	2	3	1	1	0	1	0	8
OG0003375	2	1	1	1	1	1	1	8
OG0003376	2	1	1	1	1	1	1	8
OG0003377	2	1	1	0	1	1	2	8
OG0003378	2	2	0	1	2	1	0	8
OG0003379	8	0	0	0	0	0	0	8
OG0003380	2	1	1	1	1	1	1	8
OG0003381	1	1	1	1	1	2	1	8
OG0003382	1	1	1	1	1	1	2	8
OG0003383	2	1	1	1	1	1	1	8
OG0003384	2	1	1	1	1	1	1	8
OG0003385	2	1	1	1	1	1	1	8
OG0003386	2	1	1	1	1	1	1	8
OG0003387	2	1	1	1	1	0	2	8
OG0003388	2	1	1	1	1	1	1	8
OG0003389	2	1	1	1	1	1	1	8
OG0003390	2	1	1	1	1	1	1	8
OG0003391	1	1	1	2	1	1	1	8
OG0003392	2	1	1	1	1	1	1	8
OG0003393	2	1	1	2	1	1	0	8
OG0003394	1	1	1	1	2	1	1	8
OG0003395	2	1	1	1	1	1	1	8
OG0003396	2	1	1	1	1	1	1	8
OG0003397	2	1	1	2	0	1	1	8
OG0003398	2	1	1	1	1	1	1	8
OG0003399	2	1	1	1	1	1	1	8
OG0003400	2	1	1	1	1	1	1	8
OG0003401	3	1	1	1	0	1	1	8
OG0003402	2	1	1	1	1	1	1	8
OG0003403	2	0	1	2	1	1	1	8
OG0003404	2	1	1	1	2	1	0	8
OG0003405	2	1	1	1	1	1	1	8
OG0003406	1	1	1	1	2	1	1	8
OG0003407	2	1	1	1	1	1	1	8
OG0003408	2	1	1	1	1	1	1	8
OG0003409	2	1	1	1	1	1	1	8
OG0003410	5	0	1	1	0	1	0	8
OG0003411	2	1	1	1	1	1	1	8
OG0003412	2	1	1	1	0	1	2	8
OG0003413	2	1	1	1	1	1	1	8
OG0003414	2	1	1	0	1	2	1	8
OG0003415	2	1	2	1	0	1	1	8
OG0003416	2	1	1	1	1	1	1	8
OG0003417	2	1	1	1	1	1	1	8
OG0003418	1	1	1	1	2	1	1	8
OG0003419	4	1	1	1	0	1	0	8
OG0003420	2	1	1	1	1	1	1	8
OG0003421	2	1	1	1	1	1	1	8
OG0003422	4	1	1	1	0	1	0	8
OG0003423	2	1	1	1	1	1	1	8
OG0003424	2	1	1	1	1	1	1	8
OG0003425	2	1	1	1	1	1	1	8
OG0003426	2	1	1	1	1	1	1	8
OG0003427	1	1	1	1	2	1	1	8
OG0003428	2	1	1	1	1	1	1	8
OG0003429	1	1	1	1	2	1	1	8
OG0003430	2	1	1	1	1	1	1	8
OG0003431	2	1	1	1	1	1	1	8
OG0003432	2	1	1	1	1	1	1	8
OG0003433	2	1	1	1	1	1	1	8
OG0003434	2	1	1	1	1	1	1	8
OG0003435	2	1	1	1	1	1	1	8
OG0003436	5	1	1	1	0	0	0	8
OG0003437	2	1	1	1	1	1	1	8
OG0003438	2	1	1	1	1	1	1	8
OG0003439	2	1	1	1	1	1	1	8
OG0003440	3	1	1	1	0	2	0	8
OG0003441	2	1	1	1	1	1	1	8
OG0003442	2	1	1	1	1	1	1	8
OG0003443	2	1	1	1	1	1	1	8
OG0003444	2	1	1	1	1	1	1	8
OG0003445	2	0	1	1	0	3	1	8
OG0003446	2	1	1	1	1	1	1	8
OG0003447	3	1	1	0	0	2	1	8
OG0003448	2	3	2	1	0	0	0	8
OG0003449	3	1	1	1	0	2	0	8
OG0003450	2	1	1	1	1	1	1	8
OG0003451	2	1	1	1	1	1	1	8
OG0003452	2	1	1	1	1	1	1	8
OG0003453	5	1	1	1	0	0	0	8
OG0003454	2	1	1	1	1	1	1	8
OG0003455	2	1	1	1	1	1	1	8
OG0003456	2	1	1	1	1	1	1	8
OG0003457	2	1	1	1	1	1	1	8
OG0003458	2	1	1	1	1	1	1	8
OG0003459	2	1	1	1	1	1	1	8
OG0003460	2	1	1	1	1	1	1	8
OG0003461	8	0	0	0	0	0	0	8
OG0003462	2	1	1	1	1	1	1	8
OG0003463	2	1	1	1	1	1	1	8
OG0003464	2	1	1	1	1	1	1	8
OG0003465	2	1	1	1	1	1	1	8
OG0003466	2	1	1	1	1	1	1	8
OG0003467	3	2	1	1	0	1	0	8
OG0003468	2	1	1	1	0	1	2	8
OG0003469	2	1	1	1	1	1	1	8
OG0003470	2	1	1	1	1	1	1	8
OG0003471	2	1	1	1	1	1	1	8
OG0003472	2	1	1	1	1	1	1	8
OG0003473	2	1	1	1	1	1	1	8
OG0003474	2	1	1	1	1	1	1	8
OG0003475	2	1	1	1	1	1	1	8
OG0003476	2	1	1	1	1	1	1	8
OG0003477	2	3	1	2	0	0	0	8
OG0003478	2	1	1	1	1	1	1	8
OG0003479	2	1	1	1	1	1	1	8
OG0003480	2	1	1	1	1	1	1	8
OG0003481	5	1	1	1	0	0	0	8
OG0003482	2	1	1	1	1	1	1	8
OG0003483	4	1	1	1	0	1	0	8
OG0003484	2	1	1	1	0	1	2	8
OG0003485	2	1	1	1	1	1	1	8
OG0003486	2	2	1	1	0	2	0	8
OG0003487	2	1	1	2	1	1	0	8
OG0003488	2	1	1	1	1	1	1	8
OG0003489	2	1	1	1	1	1	1	8
OG0003490	2	1	1	1	0	1	2	8
OG0003491	2	1	1	1	1	1	1	8
OG0003492	2	1	1	2	0	2	0	8
OG0003493	2	1	1	1	1	1	1	8
OG0003494	2	1	1	1	1	1	1	8
OG0003495	2	1	1	1	0	0	3	8
OG0003496	5	1	1	1	0	0	0	8
OG0003497	2	1	1	1	1	1	1	8
OG0003498	4	1	1	1	0	1	0	8
OG0003499	2	1	1	0	1	1	2	8
OG0003500	2	1	1	1	1	2	0	8
OG0003501	2	1	1	1	1	1	1	8
OG0003502	2	1	1	1	1	1	1	8
OG0003503	4	1	1	1	0	1	0	8
OG0003504	1	1	1	1	2	1	1	8
OG0003505	2	1	1	1	1	1	1	8
OG0003506	2	1	1	1	1	1	1	8
OG0003507	2	1	1	2	1	0	1	8
OG0003508	2	1	1	1	1	1	1	8
OG0003509	2	1	1	1	1	1	1	8
OG0003510	2	1	1	0	0	1	3	8
OG0003511	2	2	0	1	1	1	1	8
OG0003512	2	1	1	1	1	1	1	8
OG0003513	2	1	1	1	1	1	1	8
OG0003514	2	1	1	1	1	1	1	8
OG0003515	2	1	1	1	1	1	1	8
OG0003516	2	1	1	1	1	1	1	8
OG0003517	2	1	1	1	1	1	1	8
OG0003518	2	1	1	1	1	1	1	8
OG0003519	2	1	1	1	1	1	1	8
OG0003520	2	1	1	0	1	1	2	8
OG0003521	2	1	1	1	1	1	1	8
OG0003522	2	1	1	1	1	1	1	8
OG0003523	2	1	1	1	1	1	1	8
OG0003524	2	1	1	1	1	1	1	8
OG0003525	2	0	1	1	1	2	1	8
OG0003526	2	1	1	1	1	1	1	8
OG0003527	2	1	1	1	1	1	1	8
OG0003528	1	1	1	1	1	0	3	8
OG0003529	2	1	1	1	1	1	1	8
OG0003530	1	0	1	1	2	1	2	8
OG0003531	2	1	1	1	1	1	1	8
OG0003532	5	1	1	1	0	0	0	8
OG0003533	2	1	1	0	2	1	1	8
OG0003534	2	1	1	1	1	1	1	8
OG0003535	6	1	1	0	0	0	0	8
OG0003536	2	1	1	1	1	1	1	8
OG0003537	2	1	1	1	1	1	1	8
OG0003538	2	1	1	1	1	1	1	8
OG0003539	2	1	1	2	0	2	0	8
OG0003540	3	2	1	1	0	1	0	8
OG0003541	2	1	1	1	1	1	1	8
OG0003542	2	1	1	1	1	1	1	8
OG0003543	8	0	0	0	0	0	0	8
OG0003544	2	1	1	1	1	1	1	8
OG0003545	3	1	1	1	0	1	1	8
OG0003546	2	1	1	1	1	1	1	8
OG0003547	3	1	1	1	0	1	1	8
OG0003548	2	1	1	1	1	1	1	8
OG0003549	2	1	1	1	1	1	1	8
OG0003550	2	1	1	1	1	1	1	8
OG0003551	2	1	1	1	1	1	1	8
OG0003552	2	1	1	1	1	1	1	8
OG0003553	5	1	1	1	0	0	0	8
OG0003554	2	1	1	1	1	1	1	8
OG0003555	4	1	1	1	0	1	0	8
OG0003556	2	1	1	1	1	1	1	8
OG0003557	2	1	1	1	1	1	1	8
OG0003558	2	1	1	1	1	1	1	8
OG0003559	4	1	1	1	0	1	0	8
OG0003560	2	1	1	1	1	1	1	8
OG0003561	2	1	1	1	1	1	1	8
OG0003562	2	1	1	1	1	1	1	8
OG0003563	2	1	1	1	1	1	1	8
OG0003564	2	1	1	1	1	1	1	8
OG0003565	4	1	1	2	0	0	0	8
OG0003566	3	1	1	1	0	1	1	8
OG0003567	2	1	1	1	2	0	1	8
OG0003568	2	1	1	1	1	1	1	8
OG0003569	2	1	1	1	1	1	1	8
OG0003570	3	2	1	2	0	0	0	8
OG0003571	2	1	1	1	1	1	1	8
OG0003572	3	2	1	1	0	1	0	8
OG0003573	3	1	1	1	0	1	1	8
OG0003574	3	1	0	1	1	1	1	8
OG0003575	2	1	1	1	1	1	1	8
OG0003576	5	1	1	1	0	0	0	8
OG0003577	2	1	1	1	1	1	1	8
OG0003578	2	1	1	1	1	1	1	8
OG0003579	2	1	1	1	1	1	1	8
OG0003580	2	1	1	1	1	1	1	8
OG0003581	2	1	1	1	1	1	1	8
OG0003582	2	1	1	1	0	1	2	8
OG0003583	2	1	1	1	1	1	1	8
OG0003584	2	1	1	1	1	1	1	8
OG0003585	2	1	1	1	1	1	1	8
OG0003586	1	1	1	2	1	1	1	8
OG0003587	1	1	1	1	1	0	3	8
OG0003588	2	1	1	1	1	1	1	8
OG0003589	2	1	2	1	1	0	1	8
OG0003590	2	1	1	1	1	1	1	8
OG0003591	2	1	1	1	1	1	1	8
OG0003592	2	1	1	1	1	1	1	8
OG0003593	2	1	1	1	1	1	1	8
OG0003594	2	1	1	1	1	1	1	8
OG0003595	2	1	1	1	1	1	1	8
OG0003596	2	1	0	1	1	2	1	8
OG0003597	1	1	1	1	1	2	1	8
OG0003598	2	1	1	1	1	1	1	8
OG0003599	2	1	1	1	1	1	1	8
OG0003600	2	1	1	1	1	1	1	8
OG0003601	2	1	1	1	1	1	1	8
OG0003602	2	1	1	1	1	1	1	8
OG0003603	2	1	1	1	1	1	1	8
OG0003604	2	1	1	1	1	1	1	8
OG0003605	2	1	1	1	1	1	1	8
OG0003606	2	1	1	0	2	1	1	8
OG0003607	2	1	1	1	1	1	1	8
OG0003608	2	0	1	1	1	1	2	8
OG0003609	3	1	1	1	1	1	0	8
OG0003610	2	1	1	1	1	1	1	8
OG0003611	2	1	1	1	1	1	1	8
OG0003612	2	1	1	1	1	1	1	8
OG0003613	3	1	1	1	0	1	1	8
OG0003614	2	1	1	1	1	1	1	8
OG0003615	2	1	1	1	1	1	1	8
OG0003616	2	1	1	1	1	1	1	8
OG0003617	2	1	1	1	1	1	1	8
OG0003618	2	1	1	1	1	1	1	8
OG0003619	2	1	1	1	1	1	1	8
OG0003620	3	1	1	1	0	1	1	8
OG0003621	2	4	1	1	0	0	0	8
OG0003622	2	2	1	1	0	2	0	8
OG0003623	2	1	1	1	1	1	1	8
OG0003624	2	1	1	3	0	1	0	8
OG0003625	2	1	1	1	1	1	1	8
OG0003626	2	1	1	1	1	1	1	8
OG0003627	3	1	1	2	0	1	0	8
OG0003628	2	1	1	1	1	1	1	8
OG0003629	2	1	1	1	1	1	1	8
OG0003630	2	1	1	1	1	1	1	8
OG0003631	2	1	1	1	1	1	1	8
OG0003632	3	1	1	1	1	1	0	8
OG0003633	1	1	1	1	1	2	1	8
OG0003634	2	1	1	1	1	1	1	8
OG0003635	2	1	1	1	1	1	1	8
OG0003636	3	1	1	1	0	1	1	8
OG0003637	3	1	1	1	1	0	1	8
OG0003638	2	1	1	1	1	1	1	8
OG0003639	2	1	1	1	1	1	1	8
OG0003640	2	1	1	1	1	1	1	8
OG0003641	2	1	1	1	1	1	1	8
OG0003642	2	1	1	1	1	1	1	8
OG0003643	2	1	1	1	1	1	1	8
OG0003644	2	1	1	1	1	1	1	8
OG0003645	2	1	1	1	1	1	1	8
OG0003646	2	1	1	1	1	1	1	8
OG0003647	2	1	1	1	1	1	1	8
OG0003648	2	1	1	1	1	1	1	8
OG0003649	2	1	1	1	1	1	1	8
OG0003650	2	1	1	1	1	1	1	8
OG0003651	2	1	1	1	1	1	1	8
OG0003652	2	1	1	0	2	1	1	8
OG0003653	3	0	1	1	1	1	1	8
OG0003654	2	1	1	1	1	1	1	8
OG0003655	1	1	2	1	1	1	1	8
OG0003656	5	0	1	1	0	1	0	8
OG0003657	2	1	1	1	1	1	1	8
OG0003658	2	1	1	1	1	1	1	8
OG0003659	2	1	1	1	1	1	1	8
OG0003660	2	1	1	1	1	1	1	8
OG0003661	2	1	1	1	1	1	1	8
OG0003662	3	1	1	1	0	1	1	8
OG0003663	2	1	1	1	1	1	1	8
OG0003664	2	1	1	1	1	1	1	8
OG0003665	2	1	1	1	1	1	1	8
OG0003666	2	1	1	1	1	1	1	8
OG0003667	2	1	1	1	1	1	1	8
OG0003668	2	1	1	1	1	1	1	8
OG0003669	8	0	0	0	0	0	0	8
OG0003670	2	1	1	1	1	1	1	8
OG0003671	8	0	0	0	0	0	0	8
OG0003672	2	1	1	1	1	1	1	8
OG0003673	2	1	1	1	1	1	1	8
OG0003674	2	1	1	1	1	1	1	8
OG0003675	2	1	1	1	1	1	1	8
OG0003676	2	1	1	1	1	1	1	8
OG0003677	2	1	1	1	1	1	1	8
OG0003678	2	1	1	1	1	1	1	8
OG0003679	2	1	1	1	1	1	1	8
OG0003680	3	1	1	1	1	1	0	8
OG0003681	2	1	1	1	1	1	1	8
OG0003682	4	1	1	1	0	1	0	8
OG0003683	2	1	1	1	1	1	1	8
OG0003684	2	1	1	1	1	1	1	8
OG0003685	2	0	1	1	2	1	1	8
OG0003686	2	1	1	1	1	1	1	8
OG0003687	2	1	1	1	1	1	1	8
OG0003688	2	1	1	1	1	1	1	8
OG0003689	2	1	1	1	1	1	1	8
OG0003690	2	1	1	1	1	1	1	8
OG0003691	2	0	1	0	1	1	3	8
OG0003692	2	1	1	1	2	1	0	8
OG0003693	1	1	1	1	1	1	2	8
OG0003694	2	1	1	1	2	0	1	8
OG0003695	2	1	1	1	1	1	1	8
OG0003696	4	1	1	1	0	0	1	8
OG0003697	2	1	1	1	1	1	1	8
OG0003698	4	1	1	1	0	1	0	8
OG0003699	2	1	1	1	1	1	1	8
OG0003700	2	1	1	1	1	1	1	8
OG0003701	3	1	0	1	1	1	1	8
OG0003702	2	1	1	1	1	1	1	8
OG0003703	2	1	1	1	1	1	1	8
OG0003704	2	1	1	1	1	1	1	8
OG0003705	2	1	1	1	1	1	1	8
OG0003706	2	1	1	1	1	1	1	8
OG0003707	2	1	1	1	1	1	1	8
OG0003708	2	1	1	1	1	1	1	8
OG0003709	2	1	1	1	1	1	1	8
OG0003710	2	1	1	1	1	1	1	8
OG0003711	2	1	1	1	1	1	1	8
OG0003712	2	1	1	1	0	2	1	8
OG0003713	2	1	1	1	1	1	1	8
OG0003714	2	1	1	1	1	1	1	8
OG0003715	2	1	1	1	1	1	1	8
OG0003716	2	1	1	1	1	1	1	8
OG0003717	2	1	1	1	1	1	1	8
OG0003718	3	1	1	1	0	1	1	8
OG0003719	2	1	1	1	1	1	1	8
OG0003720	2	1	1	1	1	1	1	8
OG0003721	4	2	1	1	0	0	0	8
OG0003722	2	1	1	1	1	1	1	8
OG0003723	2	1	1	1	1	1	1	8
OG0003724	2	1	1	1	1	1	1	8
OG0003725	3	1	1	1	0	2	0	8
OG0003726	2	1	1	1	1	1	1	8
OG0003727	2	1	1	1	1	1	1	8
OG0003728	2	1	1	1	1	1	1	8
OG0003729	4	1	2	0	0	1	0	8
OG0003730	2	1	1	1	1	1	1	8
OG0003731	2	1	1	1	1	1	1	8
OG0003732	3	1	1	1	0	1	1	8
OG0003733	2	1	1	1	1	1	1	8
OG0003734	2	1	1	1	1	1	1	8
OG0003735	2	1	1	1	1	1	1	8
OG0003736	2	1	1	1	1	1	1	8
OG0003737	2	1	1	1	1	1	1	8
OG0003738	2	1	1	1	1	1	1	8
OG0003739	2	1	1	1	1	1	1	8
OG0003740	2	1	1	1	1	1	1	8
OG0003741	2	1	1	1	1	1	1	8
OG0003742	2	1	1	1	1	1	1	8
OG0003743	2	1	1	1	1	1	1	8
OG0003744	2	1	1	1	1	1	1	8
OG0003745	4	1	1	1	0	1	0	8
OG0003746	2	1	1	1	1	1	1	8
OG0003747	2	1	1	1	1	1	1	8
OG0003748	2	1	1	1	1	1	1	8
OG0003749	2	1	1	1	1	1	1	8
OG0003750	2	1	1	1	1	1	1	8
OG0003751	2	1	1	1	1	1	1	8
OG0003752	2	1	1	1	1	1	1	8
OG0003753	2	1	1	1	1	1	1	8
OG0003754	2	1	1	1	1	1	1	8
OG0003755	2	1	1	1	1	1	1	8
OG0003756	1	1	1	1	2	1	1	8
OG0003757	1	1	1	1	2	1	1	8
OG0003758	2	1	1	1	1	1	1	8
OG0003759	2	1	1	1	1	1	1	8
OG0003760	2	1	1	1	1	1	1	8
OG0003761	2	1	1	1	1	1	1	8
OG0003762	2	1	1	1	1	1	1	8
OG0003763	2	1	1	1	1	1	1	8
OG0003764	2	1	1	1	1	1	1	8
OG0003765	2	1	2	1	1	0	1	8
OG0003766	1	1	1	1	1	1	2	8
OG0003767	2	1	1	1	1	1	1	8
OG0003768	2	1	1	1	1	1	1	8
OG0003769	2	1	1	1	1	1	1	8
OG0003770	2	1	1	1	1	1	1	8
OG0003771	2	0	0	3	1	1	1	8
OG0003772	2	1	1	1	1	1	1	8
OG0003773	2	1	1	1	1	1	1	8
OG0003774	2	1	1	1	0	1	2	8
OG0003775	2	1	1	1	1	1	1	8
OG0003776	2	1	1	1	1	1	1	8
OG0003777	2	1	1	1	1	1	1	8
OG0003778	2	1	1	1	1	1	1	8
OG0003779	2	1	1	1	1	1	1	8
OG0003780	2	1	1	1	1	1	1	8
OG0003781	2	1	1	1	1	1	1	8
OG0003782	3	1	1	1	0	2	0	8
OG0003783	3	1	1	1	0	1	1	8
OG0003784	2	1	1	1	1	1	1	8
OG0003785	2	1	1	1	1	1	1	8
OG0003786	2	1	1	1	1	1	1	8
OG0003787	2	1	1	1	1	1	1	8
OG0003788	5	1	1	1	0	0	0	8
OG0003789	2	1	1	1	1	1	1	8
OG0003790	2	1	1	1	1	1	1	8
OG0003791	2	1	1	1	1	1	1	8
OG0003792	2	1	1	1	1	1	1	8
OG0003793	2	1	1	1	1	1	1	8
OG0003794	2	1	1	1	1	1	1	8
OG0003795	5	1	1	1	0	0	0	8
OG0003796	2	1	1	1	1	1	1	8
OG0003797	2	1	1	1	1	1	1	8
OG0003798	2	0	1	1	1	1	2	8
OG0003799	2	1	1	1	1	1	1	8
OG0003800	2	1	1	1	1	1	1	8
OG0003801	2	1	1	1	1	1	1	8
OG0003802	2	1	1	1	1	1	1	8
OG0003803	2	1	1	1	1	1	1	8
OG0003804	2	1	1	1	1	1	1	8
OG0003805	2	1	1	1	1	1	1	8
OG0003806	3	1	1	2	0	1	0	8
OG0003807	2	1	1	1	1	1	1	8
OG0003808	2	1	1	1	1	1	1	8
OG0003809	2	1	1	1	1	1	1	8
OG0003810	2	1	1	2	1	0	1	8
OG0003811	2	1	1	1	1	1	1	8
OG0003812	2	1	1	1	1	1	1	8
OG0003813	2	1	1	1	1	1	1	8
OG0003814	2	1	1	1	1	1	1	8
OG0003815	2	1	1	1	1	1	1	8
OG0003816	2	1	1	1	2	1	0	8
OG0003817	2	1	1	1	2	0	1	8
OG0003818	2	1	1	1	1	1	1	8
OG0003819	2	1	1	1	1	1	1	8
OG0003820	2	1	1	2	0	1	1	8
OG0003821	2	1	1	1	1	1	1	8
OG0003822	2	1	1	1	1	1	1	8
OG0003823	2	1	1	1	1	1	1	8
OG0003824	2	1	1	1	1	1	1	8
OG0003825	2	1	1	1	1	1	1	8
OG0003826	2	1	1	1	1	1	1	8
OG0003827	2	1	1	1	1	1	1	8
OG0003828	1	1	1	2	1	1	1	8
OG0003829	2	1	1	1	1	1	1	8
OG0003830	2	1	1	1	1	1	1	8
OG0003831	3	2	2	1	0	0	0	8
OG0003832	2	1	1	1	1	1	1	8
OG0003833	2	1	1	1	1	1	1	8
OG0003834	3	1	1	1	0	2	0	8
OG0003835	2	1	1	1	1	1	1	8
OG0003836	2	1	1	1	1	1	1	8
OG0003837	3	1	2	1	0	1	0	8
OG0003838	2	1	1	1	1	1	1	8
OG0003839	2	1	1	1	0	2	1	8
OG0003840	2	1	1	1	0	2	1	8
OG0003841	4	1	1	1	0	1	0	8
OG0003842	2	1	1	1	0	1	2	8
OG0003843	2	1	1	1	1	1	1	8
OG0003844	2	1	1	1	1	1	1	8
OG0003845	4	1	1	1	0	1	0	8
OG0003846	2	1	1	1	1	1	1	8
OG0003847	2	1	1	1	1	1	1	8
OG0003848	2	1	1	1	1	1	1	8
OG0003849	2	1	1	2	0	2	0	8
OG0003850	2	1	1	1	1	1	1	8
OG0003851	2	1	1	1	1	1	1	8
OG0003852	1	1	1	2	1	1	1	8
OG0003853	2	1	1	1	1	1	1	8
OG0003854	2	1	1	1	1	1	1	8
OG0003855	2	0	1	1	2	1	1	8
OG0003856	2	1	1	1	1	1	1	8
OG0003857	2	1	1	1	1	1	1	8
OG0003858	2	0	1	1	1	2	1	8
OG0003859	2	1	1	1	1	1	1	8
OG0003860	2	1	1	1	1	1	1	8
OG0003861	2	1	1	1	1	1	1	8
OG0003862	2	1	1	1	1	1	1	8
OG0003863	2	1	1	1	1	1	1	8
OG0003864	2	2	1	2	0	1	0	8
OG0003865	2	1	1	1	1	1	1	8
OG0003866	2	1	1	1	1	1	1	8
OG0003867	2	1	1	0	2	1	1	8
OG0003868	2	1	2	1	0	2	0	8
OG0003869	2	1	1	1	1	1	1	8
OG0003870	2	1	1	1	1	1	1	8
OG0003871	2	1	1	1	1	1	1	8
OG0003872	3	1	1	2	0	0	1	8
OG0003873	2	1	1	1	1	1	1	8
OG0003874	2	1	1	1	1	1	1	8
OG0003875	3	1	1	1	1	0	1	8
OG0003876	2	1	1	1	1	1	1	8
OG0003877	2	1	1	1	1	1	1	8
OG0003878	4	1	1	0	0	1	1	8
OG0003879	2	1	1	1	1	1	1	8
OG0003880	2	1	1	1	1	1	1	8
OG0003881	2	1	1	1	1	1	1	8
OG0003882	2	1	1	1	1	1	1	8
OG0003883	2	1	1	1	1	1	1	8
OG0003884	2	1	1	1	1	1	1	8
OG0003885	2	1	1	1	1	1	1	8
OG0003886	2	1	1	1	1	1	1	8
OG0003887	2	1	1	1	1	1	1	8
OG0003888	2	1	1	1	1	1	1	8
OG0003889	2	1	1	1	1	1	1	8
OG0003890	2	1	1	1	1	1	1	8
OG0003891	2	1	1	1	1	1	1	8
OG0003892	2	1	1	1	1	1	1	8
OG0003893	2	0	1	1	2	1	1	8
OG0003894	2	1	1	1	1	1	1	8
OG0003895	2	1	1	1	1	1	1	8
OG0003896	2	1	1	1	1	1	1	8
OG0003897	2	1	1	1	1	1	1	8
OG0003898	2	1	1	1	0	1	2	8
OG0003899	2	1	1	1	1	1	1	8
OG0003900	2	1	1	1	1	1	1	8
OG0003901	2	1	1	1	0	2	1	8
OG0003902	2	1	1	1	1	1	1	8
OG0003903	2	1	1	1	1	1	1	8
OG0003904	2	1	1	1	1	1	1	8
OG0003905	2	1	1	1	1	1	1	8
OG0003906	2	1	1	1	1	1	1	8
OG0003907	2	1	1	1	1	1	1	8
OG0003908	2	1	1	1	1	1	1	8
OG0003909	1	1	1	1	2	1	1	8
OG0003910	2	1	1	1	1	1	1	8
OG0003911	2	1	1	1	1	1	1	8
OG0003912	2	1	1	1	1	1	1	8
OG0003913	2	1	1	1	1	1	1	8
OG0003914	2	1	1	1	1	1	1	8
OG0003915	2	1	1	1	1	1	1	8
OG0003916	2	1	1	1	1	1	1	8
OG0003917	2	1	1	2	0	2	0	8
OG0003918	2	1	1	1	1	1	1	8
OG0003919	2	1	1	1	1	1	1	8
OG0003920	2	1	1	1	1	1	1	8
OG0003921	2	1	1	1	1	1	1	8
OG0003922	2	1	1	1	1	1	1	8
OG0003923	2	1	1	1	1	1	1	8
OG0003924	2	1	1	1	1	1	1	8
OG0003925	2	1	1	1	1	1	1	8
OG0003926	2	1	1	1	1	1	1	8
OG0003927	1	1	1	1	1	2	1	8
OG0003928	2	1	1	1	1	1	1	8
OG0003929	2	1	1	1	1	1	1	8
OG0003930	2	1	1	1	1	1	1	8
OG0003931	2	1	1	1	1	1	1	8
OG0003932	2	1	1	1	1	1	1	8
OG0003933	8	0	0	0	0	0	0	8
OG0003934	2	1	1	1	1	1	1	8
OG0003935	2	1	1	1	1	1	1	8
OG0003936	2	1	1	1	1	1	1	8
OG0003937	2	1	1	1	1	1	1	8
OG0003938	2	1	1	1	1	1	1	8
OG0003939	2	1	1	1	1	1	1	8
OG0003940	2	1	1	1	1	1	1	8
OG0003941	2	1	1	1	1	1	1	8
OG0003942	2	1	1	1	1	1	1	8
OG0003943	2	1	1	1	1	1	1	8
OG0003944	2	1	1	1	1	1	1	8
OG0003945	2	1	1	1	1	1	1	8
OG0003946	4	1	1	0	0	1	1	8
OG0003947	2	1	1	1	1	1	1	8
OG0003948	2	1	1	1	1	1	1	8
OG0003949	2	1	1	1	1	1	1	8
OG0003950	2	1	1	1	1	1	1	8
OG0003951	2	1	1	1	1	1	1	8
OG0003952	2	1	1	1	1	1	1	8
OG0003953	1	1	1	1	2	1	1	8
OG0003954	1	1	1	1	2	1	1	8
OG0003955	2	1	1	1	2	0	1	8
OG0003956	2	1	1	1	1	1	1	8
OG0003957	2	1	1	1	1	1	1	8
OG0003958	2	1	1	1	1	1	1	8
OG0003959	4	1	1	1	0	1	0	8
OG0003960	2	1	0	1	2	1	1	8
OG0003961	2	1	1	1	1	1	1	8
OG0003962	2	1	1	1	2	0	1	8
OG0003963	2	1	1	1	1	1	1	8
OG0003964	2	1	1	1	1	1	1	8
OG0003965	2	1	1	1	1	1	1	8
OG0003966	2	1	1	1	1	1	1	8
OG0003967	2	1	1	2	0	2	0	8
OG0003968	2	1	1	1	1	1	1	8
OG0003969	2	1	1	1	1	1	1	8
OG0003970	3	1	2	1	0	1	0	8
OG0003971	2	1	1	0	2	0	2	8
OG0003972	2	1	1	1	1	1	1	8
OG0003973	2	1	1	1	1	1	1	8
OG0003974	3	1	1	1	1	1	0	8
OG0003975	3	1	1	0	1	1	1	8
OG0003976	2	1	1	1	1	1	1	8
OG0003977	2	1	1	1	1	1	1	8
OG0003978	2	1	1	1	1	1	1	8
OG0003979	2	1	1	1	1	1	1	8
OG0003980	2	1	1	1	1	1	1	8
OG0003981	8	0	0	0	0	0	0	8
OG0003982	3	1	1	1	0	1	1	8
OG0003983	3	0	1	1	1	1	1	8
OG0003984	4	1	1	1	0	1	0	8
OG0003985	2	1	1	1	1	1	1	8
OG0003986	2	1	1	1	1	1	1	8
OG0003987	2	1	1	1	1	1	1	8
OG0003988	2	1	1	1	1	1	1	8
OG0003989	2	1	1	1	2	1	0	8
OG0003990	2	1	1	1	1	1	1	8
OG0003991	2	1	1	1	1	1	1	8
OG0003992	2	1	1	1	1	1	1	8
OG0003993	2	1	1	1	1	1	1	8
OG0003994	3	2	1	1	0	1	0	8
OG0003995	2	1	1	1	1	0	2	8
OG0003996	2	1	1	1	1	1	1	8
OG0003997	2	1	1	1	1	1	1	8
OG0003998	3	1	1	1	1	0	1	8
OG0003999	2	1	1	1	1	1	1	8
OG0004000	2	1	1	1	1	1	1	8
OG0004001	2	1	1	1	1	1	1	8
OG0004002	2	1	1	1	1	1	1	8
OG0004003	2	1	1	1	1	1	1	8
OG0004004	2	1	1	1	1	1	1	8
OG0004005	2	1	1	1	1	1	1	8
OG0004006	2	1	1	1	1	1	1	8
OG0004007	2	1	1	1	1	1	1	8
OG0004008	2	1	2	2	0	1	0	8
OG0004009	1	1	1	1	1	1	2	8
OG0004010	2	1	1	1	1	1	1	8
OG0004011	1	1	1	1	2	1	1	8
OG0004012	2	1	1	1	1	1	1	8
OG0004013	2	1	1	1	1	1	1	8
OG0004014	2	1	1	1	1	1	1	8
OG0004015	1	1	1	1	1	2	1	8
OG0004016	1	1	1	1	1	1	2	8
OG0004017	2	1	1	1	1	1	1	8
OG0004018	2	1	1	1	1	1	1	8
OG0004019	2	1	1	1	1	1	1	8
OG0004020	2	1	1	1	1	1	1	8
OG0004021	2	1	1	0	1	2	1	8
OG0004022	2	1	1	1	1	1	1	8
OG0004023	2	1	1	1	1	1	1	8
OG0004024	2	1	0	1	1	1	2	8
OG0004025	3	1	2	1	0	1	0	8
OG0004026	2	1	1	1	1	1	1	8
OG0004027	2	1	1	1	1	2	0	8
OG0004028	2	1	1	1	1	1	1	8
OG0004029	3	1	0	1	1	1	1	8
OG0004030	2	1	1	1	1	1	1	8
OG0004031	2	1	1	1	1	1	1	8
OG0004032	2	1	1	1	1	1	1	8
OG0004033	2	1	1	1	1	1	1	8
OG0004034	2	1	1	1	0	1	2	8
OG0004035	2	1	1	1	1	1	1	8
OG0004036	2	1	0	1	1	1	2	8
OG0004037	2	1	1	1	0	3	0	8
OG0004038	2	1	1	1	1	1	1	8
OG0004039	2	1	1	1	1	1	1	8
OG0004040	2	1	1	1	1	1	1	8
OG0004041	2	1	1	2	1	0	1	8
OG0004042	2	2	1	2	0	1	0	8
OG0004043	2	1	1	1	1	1	1	8
OG0004044	2	1	1	1	1	1	1	8
OG0004045	1	1	1	1	1	1	2	8
OG0004046	2	1	1	1	1	1	1	8
OG0004047	1	1	1	1	1	2	1	8
OG0004048	2	1	1	1	1	1	1	8
OG0004049	2	1	0	2	1	1	1	8
OG0004050	2	1	1	1	1	1	1	8
OG0004051	2	1	1	1	1	1	1	8
OG0004052	2	1	1	1	1	1	1	8
OG0004053	1	1	1	1	1	1	2	8
OG0004054	3	1	2	0	1	1	0	8
OG0004055	2	1	1	1	1	1	1	8
OG0004056	3	1	1	1	0	2	0	8
OG0004057	3	1	1	1	0	1	1	8
OG0004058	2	1	1	1	1	1	1	8
OG0004059	2	1	1	1	1	1	1	8
OG0004060	2	1	1	1	1	1	1	8
OG0004061	1	2	1	2	0	1	1	8
OG0004062	2	1	1	1	1	1	1	8
OG0004063	7	0	1	0	0	0	0	8
OG0004064	1	1	1	1	2	1	1	8
OG0004065	2	1	1	1	1	1	1	8
OG0004066	3	1	1	1	0	2	0	8
OG0004067	2	1	1	1	1	1	1	8
OG0004068	4	1	1	1	0	1	0	8
OG0004069	3	1	1	1	1	0	1	8
OG0004070	2	1	1	1	1	1	1	8
OG0004071	2	1	1	1	1	1	1	8
OG0004072	2	1	1	1	1	1	1	8
OG0004073	2	1	1	0	1	1	2	8
OG0004074	3	1	1	1	1	1	0	8
OG0004075	2	1	1	1	1	1	1	8
OG0004076	1	1	1	2	1	1	1	8
OG0004077	2	1	1	1	1	1	1	8
OG0004078	2	1	1	1	1	1	1	8
OG0004079	2	1	1	1	1	1	1	8
OG0004080	2	1	1	1	1	1	1	8
OG0004081	2	1	1	1	1	1	1	8
OG0004082	2	1	1	1	1	1	1	8
OG0004083	2	1	1	1	1	1	1	8
OG0004084	2	1	1	1	1	1	1	8
OG0004085	2	1	1	1	1	1	1	8
OG0004086	2	1	1	1	1	1	1	8
OG0004087	2	1	1	1	0	1	2	8
OG0004088	2	1	1	1	1	1	1	8
OG0004089	3	2	1	1	0	1	0	8
OG0004090	2	1	1	1	1	1	1	8
OG0004091	4	1	1	1	0	1	0	8
OG0004092	2	1	1	1	1	1	1	8
OG0004093	2	1	1	1	1	1	1	8
OG0004094	2	1	1	1	1	1	1	8
OG0004095	2	1	1	1	1	1	1	8
OG0004096	2	1	1	2	1	1	0	8
OG0004097	2	1	1	1	1	1	1	8
OG0004098	2	1	1	1	1	1	1	8
OG0004099	2	1	1	1	1	1	1	8
OG0004100	2	1	1	2	1	0	1	8
OG0004101	2	1	1	1	1	1	1	8
OG0004102	2	1	1	2	1	0	1	8
OG0004103	2	1	1	1	1	1	1	8
OG0004104	2	1	1	2	0	1	1	8
OG0004105	2	1	1	1	1	1	1	8
OG0004106	2	1	1	1	1	1	1	8
OG0004107	2	1	1	1	1	1	1	8
OG0004108	2	1	1	1	1	1	1	8
OG0004109	2	1	1	1	1	1	1	8
OG0004110	2	1	1	1	1	1	1	8
OG0004111	2	1	1	1	1	1	1	8
OG0004112	1	1	2	1	1	1	1	8
OG0004113	2	1	1	1	1	1	1	8
OG0004114	2	1	1	1	1	1	1	8
OG0004115	2	1	1	1	1	1	1	8
OG0004116	2	1	1	1	1	1	1	8
OG0004117	2	1	1	1	1	1	1	8
OG0004118	1	1	1	1	2	1	1	8
OG0004119	2	1	1	1	1	1	1	8
OG0004120	2	1	1	1	1	1	1	8
OG0004121	2	1	1	1	1	1	1	8
OG0004122	2	1	1	1	1	1	1	8
OG0004123	2	1	1	1	1	1	1	8
OG0004124	2	1	1	1	1	1	1	8
OG0004125	2	1	1	1	1	1	1	8
OG0004126	2	1	1	1	1	1	1	8
OG0004127	2	1	1	1	1	1	1	8
OG0004128	2	1	1	1	1	1	1	8
OG0004129	1	1	1	1	1	1	2	8
OG0004130	2	1	1	0	2	1	1	8
OG0004131	2	1	2	2	0	1	0	8
OG0004132	2	1	1	1	1	1	1	8
OG0004133	1	1	1	1	2	1	1	8
OG0004134	2	1	1	1	1	1	1	8
OG0004135	3	1	1	1	0	1	1	8
OG0004136	1	1	1	2	1	1	1	8
OG0004137	1	1	1	2	0	3	0	8
OG0004138	2	1	1	1	1	1	1	8
OG0004139	2	1	1	1	1	1	1	8
OG0004140	1	2	1	2	1	1	0	8
OG0004141	1	1	1	1	2	1	1	8
OG0004142	1	1	1	1	2	1	1	8
OG0004143	1	1	1	1	0	1	3	8
OG0004144	1	1	1	1	1	2	1	8
OG0004145	2	1	1	1	1	1	1	8
OG0004146	2	1	1	1	1	1	1	8
OG0004147	1	1	1	1	1	2	1	8
OG0004148	1	1	1	1	2	1	1	8
OG0004149	1	1	1	2	1	1	1	8
OG0004150	1	1	1	1	1	1	2	8
OG0004151	2	1	1	1	1	1	1	8
OG0004152	4	3	1	0	0	0	0	8
OG0004153	2	1	1	1	1	1	1	8
OG0004154	2	1	1	1	2	0	1	8
OG0004155	2	1	1	1	1	1	1	8
OG0004156	2	1	1	1	1	1	1	8
OG0004157	2	1	1	1	1	1	1	8
OG0004158	2	1	1	1	1	1	1	8
OG0004159	2	1	1	1	1	1	1	8
OG0004160	2	1	1	1	2	0	1	8
OG0004161	2	1	1	1	1	1	1	8
OG0004162	2	1	1	1	1	1	1	8
OG0004163	3	1	0	1	1	1	1	8
OG0004164	2	1	1	1	1	1	1	8
OG0004165	2	1	0	1	2	1	1	8
OG0004166	2	1	1	1	1	1	1	8
OG0004167	2	1	1	1	1	1	1	8
OG0004168	2	1	1	1	1	1	1	8
OG0004169	2	1	2	1	0	1	1	8
OG0004170	2	1	1	1	1	1	1	8
OG0004171	2	1	1	1	1	1	1	8
OG0004172	2	1	1	1	1	1	1	8
OG0004173	2	1	1	1	1	1	1	8
OG0004174	2	1	1	1	1	1	1	8
OG0004175	2	1	1	1	1	1	1	8
OG0004176	2	1	1	1	1	1	1	8
OG0004177	2	1	1	1	1	0	2	8
OG0004178	2	1	1	1	1	1	1	8
OG0004179	3	0	1	1	1	1	1	8
OG0004180	2	1	1	1	1	1	1	8
OG0004181	2	1	1	1	1	1	1	8
OG0004182	2	1	1	1	1	1	1	8
OG0004183	2	2	0	1	1	1	1	8
OG0004184	2	1	1	1	1	1	1	8
OG0004185	2	1	1	1	1	1	1	8
OG0004186	2	1	1	1	0	1	2	8
OG0004187	2	1	1	1	1	1	1	8
OG0004188	2	1	1	1	1	1	1	8
OG0004189	2	1	1	1	1	2	0	8
OG0004190	3	1	1	1	0	2	0	8
OG0004191	2	1	1	1	1	1	1	8
OG0004192	2	1	1	1	1	1	1	8
OG0004193	2	1	1	1	1	1	1	8
OG0004194	2	1	1	1	1	1	1	8
OG0004195	3	0	1	1	1	1	1	8
OG0004196	2	1	1	1	1	1	1	8
OG0004197	2	1	1	1	1	1	1	8
OG0004198	1	1	1	1	2	1	1	8
OG0004199	1	1	1	1	1	1	2	8
OG0004200	1	1	1	1	1	2	1	8
OG0004201	1	1	1	1	2	1	1	8
OG0004202	2	1	1	1	1	1	1	8
OG0004203	2	1	1	1	1	1	1	8
OG0004204	3	1	1	0	1	1	1	8
OG0004205	1	1	1	1	1	1	2	8
OG0004206	4	1	1	1	0	1	0	8
OG0004207	2	1	1	1	1	1	1	8
OG0004208	2	1	1	1	1	1	1	8
OG0004209	8	0	0	0	0	0	0	8
OG0004210	4	2	1	1	0	0	0	8
OG0004211	2	1	1	1	2	1	0	8
OG0004212	1	1	1	1	2	2	0	8
OG0004213	2	1	1	1	1	1	1	8
OG0004214	2	1	1	1	1	1	1	8
OG0004215	2	1	1	1	1	1	1	8
OG0004216	2	1	1	1	1	1	1	8
OG0004217	2	1	1	1	1	1	1	8
OG0004218	2	1	1	1	1	1	1	8
OG0004219	2	1	1	1	1	1	1	8
OG0004220	2	1	1	1	1	1	1	8
OG0004221	1	1	1	1	2	1	1	8
OG0004222	2	1	1	1	1	1	1	8
OG0004223	2	1	1	1	1	1	1	8
OG0004224	2	1	1	1	1	1	1	8
OG0004225	2	1	1	1	1	1	1	8
OG0004226	2	1	1	1	1	1	1	8
OG0004227	2	1	1	1	1	1	1	8
OG0004228	4	1	1	1	1	0	0	8
OG0004229	2	1	1	1	1	1	1	8
OG0004230	2	1	1	1	1	1	1	8
OG0004231	2	1	1	1	1	1	1	8
OG0004232	2	1	1	1	1	1	1	8
OG0004233	3	1	1	1	0	1	1	8
OG0004234	2	1	1	1	0	2	1	8
OG0004235	2	1	1	1	1	1	1	8
OG0004236	2	1	1	1	1	1	1	8
OG0004237	2	1	1	1	1	1	1	8
OG0004238	2	1	1	1	1	1	1	8
OG0004239	2	1	1	1	1	1	1	8
OG0004240	2	1	1	1	1	1	1	8
OG0004241	2	1	1	1	1	1	1	8
OG0004242	2	1	1	1	1	1	1	8
OG0004243	2	1	1	1	1	1	1	8
OG0004244	2	1	1	1	1	1	1	8
OG0004245	2	1	1	1	1	1	1	8
OG0004246	2	1	1	1	1	1	1	8
OG0004247	2	1	1	1	2	1	0	8
OG0004248	4	1	1	1	0	1	0	8
OG0004249	2	1	1	1	1	1	1	8
OG0004250	2	1	1	1	1	1	1	8
OG0004251	1	1	1	2	1	1	1	8
OG0004252	2	1	1	1	1	1	1	8
OG0004253	2	1	1	1	1	1	1	8
OG0004254	2	1	1	1	1	1	1	8
OG0004255	2	1	1	1	1	1	1	8
OG0004256	1	1	1	1	2	1	1	8
OG0004257	1	1	1	1	2	1	1	8
OG0004258	1	1	1	1	2	1	1	8
OG0004259	2	1	1	1	1	1	1	8
OG0004260	2	1	1	1	1	1	1	8
OG0004261	2	1	1	1	1	1	1	8
OG0004262	2	1	1	1	1	1	1	8
OG0004263	2	1	1	1	1	1	1	8
OG0004264	2	2	2	2	0	0	0	8
OG0004265	2	1	1	1	1	1	1	8
OG0004266	2	1	1	1	1	0	2	8
OG0004267	2	1	1	1	1	1	1	8
OG0004268	2	1	1	1	1	1	1	8
OG0004269	2	1	1	1	1	1	1	8
OG0004270	2	1	1	1	1	1	1	8
OG0004271	2	1	1	0	2	1	1	8
OG0004272	2	1	1	1	1	1	1	8
OG0004273	3	1	1	1	1	0	1	8
OG0004274	2	1	1	1	1	1	1	8
OG0004275	1	1	1	1	1	1	2	8
OG0004276	2	1	1	1	1	1	1	8
OG0004277	4	1	1	1	0	1	0	8
OG0004278	2	1	1	1	1	1	1	8
OG0004279	2	1	1	1	1	1	1	8
OG0004280	2	1	1	1	1	1	1	8
OG0004281	2	1	1	1	1	1	1	8
OG0004282	3	1	1	1	0	2	0	8
OG0004283	2	1	1	1	1	1	1	8
OG0004284	2	1	1	1	0	1	2	8
OG0004285	1	1	1	1	1	2	1	8
OG0004286	1	1	1	1	1	0	3	8
OG0004287	1	2	1	1	1	1	1	8
OG0004288	2	1	1	1	1	1	1	8
OG0004289	2	1	1	1	1	1	1	8
OG0004290	2	1	1	1	1	1	1	8
OG0004291	4	1	1	1	0	1	0	8
OG0004292	1	1	1	1	2	1	1	8
OG0004293	1	1	1	1	1	2	1	8
OG0004294	1	1	1	2	1	1	1	8
OG0004295	1	1	1	1	1	2	1	8
OG0004296	1	4	1	1	0	0	1	8
OG0004297	0	8	0	0	0	0	0	8
OG0004298	0	1	3	4	0	0	0	8
OG0004299	0	8	0	0	0	0	0	8
OG0004300	0	3	1	4	0	0	0	8
OG0004301	0	8	0	0	0	0	0	8
OG0004302	0	8	0	0	0	0	0	8
OG0004303	0	6	0	2	0	0	0	8
OG0004304	0	1	1	2	1	2	1	8
OG0004305	0	8	0	0	0	0	0	8
OG0004306	0	1	7	0	0	0	0	8
OG0004307	0	1	1	5	0	1	0	8
OG0004308	0	3	0	5	0	0	0	8
OG0004309	0	1	4	3	0	0	0	8
OG0004310	0	1	2	5	0	0	0	8
OG0004311	0	1	1	1	1	1	3	8
OG0004312	0	1	1	2	1	1	2	8
OG0004313	0	1	1	1	0	1	4	8
OG0004314	0	1	5	2	0	0	0	8
OG0004315	0	1	0	7	0	0	0	8
OG0004316	0	0	8	0	0	0	0	8
OG0004317	0	0	1	1	1	1	4	8
OG0004318	0	0	8	0	0	0	0	8
OG0004319	0	0	8	0	0	0	0	8
OG0004320	0	0	1	1	3	2	1	8
OG0004321	0	0	8	0	0	0	0	8
OG0004322	0	0	8	0	0	0	0	8
OG0004323	0	0	8	0	0	0	0	8
OG0004324	0	0	7	1	0	0	0	8
OG0004325	0	0	8	0	0	0	0	8
OG0004326	0	0	1	1	0	6	0	8
OG0004327	0	0	1	1	0	0	6	8
OG0004328	0	0	1	4	0	3	0	8
OG0004329	0	0	1	7	0	0	0	8
OG0004330	0	0	4	3	0	0	1	8
OG0004331	0	0	8	0	0	0	0	8
OG0004332	0	0	0	5	0	1	2	8
OG0004333	0	0	0	8	0	0	0	8
OG0004334	0	0	0	8	0	0	0	8
OG0004335	0	0	0	8	0	0	0	8
OG0004336	0	0	0	8	0	0	0	8
OG0004337	0	0	0	8	0	0	0	8
OG0004338	0	0	0	8	0	0	0	8
OG0004339	0	0	0	8	0	0	0	8
OG0004340	0	0	0	8	0	0	0	8
OG0004341	0	0	0	8	0	0	0	8
OG0004342	0	0	0	8	0	0	0	8
OG0004343	0	0	0	8	0	0	0	8
OG0004344	0	0	0	8	0	0	0	8
OG0004345	0	0	0	8	0	0	0	8
OG0004346	0	0	0	0	7	0	1	8
OG0004347	0	0	0	0	1	0	7	8
OG0004348	0	0	0	0	3	1	4	8
OG0004349	0	0	0	0	5	1	2	8
OG0004350	0	0	0	0	2	0	6	8
OG0004351	0	0	0	0	1	0	7	8
OG0004352	0	0	0	0	7	0	1	8
OG0004353	0	0	0	0	6	1	1	8
OG0004354	0	0	0	0	3	1	4	8
OG0004355	0	0	0	0	5	0	3	8
OG0004356	0	0	0	0	4	1	3	8
OG0004357	0	0	0	0	4	0	4	8
OG0004358	0	0	0	0	3	0	5	8
OG0004359	0	0	0	0	2	0	6	8
OG0004360	0	0	0	0	4	1	3	8
OG0004361	0	0	0	0	2	0	6	8
OG0004362	0	0	0	0	1	0	7	8
OG0004363	0	0	0	0	1	6	1	8
OG0004364	0	0	0	0	4	0	4	8
OG0004365	0	0	0	0	1	0	7	8
OG0004366	0	0	0	0	1	0	7	8
OG0004367	0	0	0	0	1	0	7	8
OG0004368	0	0	0	0	1	2	5	8
OG0004369	0	0	0	0	2	1	5	8
OG0004370	0	0	0	0	2	4	2	8
OG0004371	0	0	0	0	4	0	4	8
OG0004372	0	0	0	0	1	1	6	8
OG0004373	0	0	0	0	1	1	6	8
OG0004374	0	0	0	0	0	8	0	8
OG0004375	0	0	0	0	0	6	2	8
OG0004376	0	0	0	0	0	8	0	8
OG0004377	0	0	0	0	0	8	0	8
OG0004378	0	0	0	0	0	8	0	8
OG0004379	0	0	0	0	0	8	0	8
OG0004380	0	0	0	0	0	8	0	8
OG0004381	0	0	0	0	0	8	0	8
OG0004382	0	0	0	0	0	8	0	8
OG0004383	0	0	0	0	0	8	0	8
OG0004384	0	0	0	0	0	8	0	8
OG0004385	0	0	0	0	0	1	7	8
OG0004386	0	0	0	0	0	0	8	8
OG0004387	0	0	0	0	0	0	8	8
OG0004388	0	0	0	0	0	0	8	8
OG0004389	0	0	0	0	0	0	8	8
OG0004390	0	0	0	0	0	0	8	8
OG0004391	0	0	0	0	0	0	8	8
OG0004392	0	0	0	0	0	0	8	8
OG0004393	0	0	0	0	0	0	8	8
OG0004394	0	0	0	0	0	0	8	8
OG0004395	0	0	0	0	0	0	8	8
OG0004396	0	0	0	0	0	0	8	8
OG0004397	0	0	0	0	0	0	8	8
OG0004398	0	0	0	0	0	0	8	8
OG0004399	0	0	0	0	0	0	8	8
OG0004400	0	0	0	0	0	0	8	8
OG0004401	0	0	0	0	0	0	8	8
OG0004402	0	0	0	0	0	0	8	8
OG0004403	0	0	0	0	0	0	8	8
OG0004404	0	0	0	0	0	0	8	8
OG0004405	0	0	0	0	0	0	8	8
OG0004406	0	0	0	0	0	0	8	8
OG0004407	0	0	0	0	0	0	8	8
OG0004408	0	0	0	0	0	0	8	8
OG0004409	0	0	0	0	0	0	8	8
OG0004410	0	0	0	0	0	0	8	8
OG0004411	0	0	0	0	0	0	8	8
OG0004412	0	0	0	0	0	0	8	8
OG0004413	0	0	0	0	0	0	8	8
OG0004414	0	0	0	0	0	0	8	8
OG0004415	0	0	0	0	0	0	8	8
OG0004416	0	0	0	0	0	0	8	8
OG0004417	0	0	0	0	0	0	8	8
OG0004418	0	0	0	0	0	0	8	8
OG0004419	0	0	0	0	0	0	8	8
OG0004420	0	0	0	0	0	0	8	8
OG0004421	0	0	0	0	0	0	8	8
OG0004422	0	0	0	0	0	0	8	8
OG0004423	2	1	1	1	1	1	0	7
OG0004424	5	0	0	1	0	0	1	7
OG0004425	7	0	0	0	0	0	0	7
OG0004426	2	1	1	1	1	0	1	7
OG0004427	3	1	1	1	0	1	0	7
OG0004428	2	1	1	0	1	1	1	7
OG0004429	2	1	1	0	1	1	1	7
OG0004430	3	1	1	1	0	1	0	7
OG0004431	2	1	0	1	1	1	1	7
OG0004432	2	1	1	1	1	0	1	7
OG0004433	2	1	1	2	0	1	0	7
OG0004434	1	1	1	1	1	1	1	7
OG0004435	2	0	1	1	1	1	1	7
OG0004436	2	0	1	0	2	1	1	7
OG0004437	1	3	1	1	0	0	1	7
OG0004438	2	1	0	1	1	0	2	7
OG0004439	2	1	0	1	1	1	1	7
OG0004440	4	1	1	0	0	1	0	7
OG0004441	4	0	2	1	0	0	0	7
OG0004442	4	1	1	1	0	0	0	7
OG0004443	2	1	1	1	0	1	1	7
OG0004444	2	0	1	1	1	1	1	7
OG0004445	2	1	1	1	0	1	1	7
OG0004446	2	1	1	0	1	1	1	7
OG0004447	2	1	2	1	0	1	0	7
OG0004448	2	1	1	1	0	1	1	7
OG0004449	2	1	2	1	0	1	0	7
OG0004450	2	1	1	1	0	1	1	7
OG0004451	2	1	1	1	0	1	1	7
OG0004452	2	1	1	1	0	1	1	7
OG0004453	1	1	1	1	1	1	1	7
OG0004454	2	1	1	1	0	1	1	7
OG0004455	1	1	1	1	1	1	1	7
OG0004456	2	1	1	1	0	1	1	7
OG0004457	2	1	1	1	0	1	1	7
OG0004458	2	1	1	1	1	0	1	7
OG0004459	2	1	1	1	0	1	1	7
OG0004460	2	1	1	1	0	1	1	7
OG0004461	2	1	1	1	1	0	1	7
OG0004462	2	1	1	1	0	1	1	7
OG0004463	2	1	2	1	0	1	0	7
OG0004464	2	1	0	1	2	0	1	7
OG0004465	2	1	0	1	1	1	1	7
OG0004466	4	1	1	1	0	0	0	7
OG0004467	2	1	1	1	1	1	0	7
OG0004468	2	1	1	0	1	1	1	7
OG0004469	2	1	1	0	1	1	1	7
OG0004470	3	1	1	1	0	0	1	7
OG0004471	2	1	1	1	0	1	1	7
OG0004472	2	1	1	2	0	1	0	7
OG0004473	3	1	1	1	0	1	0	7
OG0004474	2	1	1	1	1	0	1	7
OG0004475	2	1	1	1	0	1	1	7
OG0004476	3	2	1	1	0	0	0	7
OG0004477	2	1	1	0	1	1	1	7
OG0004478	3	1	0	1	1	1	0	7
OG0004479	2	1	1	1	1	0	1	7
OG0004480	2	1	2	1	0	1	0	7
OG0004481	2	1	1	0	1	1	1	7
OG0004482	2	1	1	1	0	1	1	7
OG0004483	2	1	1	1	0	1	1	7
OG0004484	2	1	1	1	0	1	1	7
OG0004485	4	1	1	1	0	0	0	7
OG0004486	3	1	1	1	0	1	0	7
OG0004487	2	1	1	1	0	1	1	7
OG0004488	2	1	1	1	0	1	1	7
OG0004489	2	1	1	1	0	1	1	7
OG0004490	2	1	1	0	1	1	1	7
OG0004491	2	1	1	1	0	1	1	7
OG0004492	3	1	1	1	0	1	0	7
OG0004493	2	1	1	1	0	1	1	7
OG0004494	2	1	1	1	1	0	1	7
OG0004495	2	1	0	1	1	1	1	7
OG0004496	2	0	1	1	0	3	0	7
OG0004497	2	1	1	2	0	1	0	7
OG0004498	2	0	1	1	1	1	1	7
OG0004499	4	1	1	1	0	0	0	7
OG0004500	3	1	1	1	0	1	0	7
OG0004501	2	1	1	0	1	1	1	7
OG0004502	1	1	1	1	1	1	1	7
OG0004503	2	1	1	1	0	1	1	7
OG0004504	3	1	1	1	0	1	0	7
OG0004505	2	2	1	1	0	1	0	7
OG0004506	3	1	1	1	0	1	0	7
OG0004507	2	1	1	1	1	1	0	7
OG0004508	2	1	1	0	1	1	1	7
OG0004509	3	1	1	1	0	1	0	7
OG0004510	2	1	1	1	0	2	0	7
OG0004511	2	3	1	0	0	1	0	7
OG0004512	2	1	1	1	0	1	1	7
OG0004513	2	1	0	1	1	1	1	7
OG0004514	2	1	1	1	0	1	1	7
OG0004515	2	1	1	1	0	1	1	7
OG0004516	3	1	1	1	0	1	0	7
OG0004517	2	1	1	0	1	1	1	7
OG0004518	2	1	2	1	0	1	0	7
OG0004519	2	1	2	1	0	1	0	7
OG0004520	2	2	1	1	0	1	0	7
OG0004521	2	0	3	1	0	1	0	7
OG0004522	2	1	1	0	1	1	1	7
OG0004523	1	1	1	1	1	1	1	7
OG0004524	1	1	1	1	1	1	1	7
OG0004525	2	1	1	1	0	1	1	7
OG0004526	2	1	1	1	1	0	1	7
OG0004527	1	1	1	1	1	1	1	7
OG0004528	1	1	1	1	0	1	2	7
OG0004529	1	1	1	1	1	1	1	7
OG0004530	3	1	1	1	0	1	0	7
OG0004531	3	1	1	1	0	1	0	7
OG0004532	2	1	1	1	0	2	0	7
OG0004533	3	1	1	1	0	0	1	7
OG0004534	2	1	1	1	0	1	1	7
OG0004535	3	1	1	1	0	1	0	7
OG0004536	2	1	1	0	1	1	1	7
OG0004537	2	1	1	1	1	1	0	7
OG0004538	2	1	1	2	0	1	0	7
OG0004539	1	1	1	1	1	1	1	7
OG0004540	3	1	2	1	0	0	0	7
OG0004541	2	0	1	0	2	1	1	7
OG0004542	1	1	1	1	1	1	1	7
OG0004543	3	1	0	1	1	0	1	7
OG0004544	2	1	1	1	0	1	1	7
OG0004545	2	1	1	1	1	1	0	7
OG0004546	3	1	1	1	0	1	0	7
OG0004547	3	1	1	1	0	1	0	7
OG0004548	3	1	1	1	0	1	0	7
OG0004549	4	1	1	1	0	0	0	7
OG0004550	2	1	1	1	0	2	0	7
OG0004551	2	1	1	2	0	1	0	7
OG0004552	2	1	0	1	1	1	1	7
OG0004553	2	1	1	1	0	1	1	7
OG0004554	2	1	1	1	1	0	1	7
OG0004555	1	1	1	1	1	1	1	7
OG0004556	3	2	1	1	0	0	0	7
OG0004557	2	1	1	1	0	2	0	7
OG0004558	2	1	1	1	1	0	1	7
OG0004559	2	1	1	2	1	0	0	7
OG0004560	4	1	1	1	0	0	0	7
OG0004561	2	1	1	1	1	0	1	7
OG0004562	3	1	1	2	0	0	0	7
OG0004563	7	0	0	0	0	0	0	7
OG0004564	1	1	1	0	0	2	2	7
OG0004565	2	1	1	1	1	0	1	7
OG0004566	2	1	1	1	0	1	1	7
OG0004567	6	1	0	0	0	0	0	7
OG0004568	2	1	1	1	1	0	1	7
OG0004569	2	1	1	1	0	2	0	7
OG0004570	1	4	0	1	0	0	1	7
OG0004571	2	1	1	1	0	2	0	7
OG0004572	2	1	1	1	1	0	1	7
OG0004573	2	1	1	1	1	0	1	7
OG0004574	2	1	1	1	0	1	1	7
OG0004575	3	1	1	1	0	1	0	7
OG0004576	6	0	0	0	0	0	1	7
OG0004577	2	1	1	0	1	0	2	7
OG0004578	2	1	1	1	1	0	1	7
OG0004579	1	1	1	1	1	1	1	7
OG0004580	2	1	1	1	0	2	0	7
OG0004581	2	1	1	1	0	2	0	7
OG0004582	2	1	1	1	0	2	0	7
OG0004583	3	1	1	1	0	1	0	7
OG0004584	3	0	1	0	1	1	1	7
OG0004585	2	1	1	1	0	1	1	7
OG0004586	2	1	1	1	1	0	1	7
OG0004587	3	1	1	2	0	0	0	7
OG0004588	3	1	1	1	0	1	0	7
OG0004589	3	1	1	1	0	1	0	7
OG0004590	2	1	3	1	0	0	0	7
OG0004591	2	0	2	1	0	1	1	7
OG0004592	2	1	1	1	1	0	1	7
OG0004593	2	1	1	1	1	1	0	7
OG0004594	2	1	1	0	1	1	1	7
OG0004595	4	1	1	1	0	0	0	7
OG0004596	2	1	1	2	0	1	0	7
OG0004597	2	1	0	1	1	1	1	7
OG0004598	3	2	1	1	0	0	0	7
OG0004599	2	1	1	1	1	0	1	7
OG0004600	2	1	2	1	0	1	0	7
OG0004601	6	0	1	0	0	0	0	7
OG0004602	2	1	1	0	0	2	1	7
OG0004603	1	1	1	1	1	1	1	7
OG0004604	4	1	1	1	0	0	0	7
OG0004605	2	1	1	1	0	1	1	7
OG0004606	2	1	1	2	0	1	0	7
OG0004607	6	0	1	0	0	0	0	7
OG0004608	2	1	0	1	1	1	1	7
OG0004609	2	1	1	0	1	1	1	7
OG0004610	3	1	1	1	0	1	0	7
OG0004611	2	1	0	1	1	1	1	7
OG0004612	2	2	1	1	0	1	0	7
OG0004613	3	1	0	0	1	1	1	7
OG0004614	5	1	0	1	0	0	0	7
OG0004615	4	1	1	1	0	0	0	7
OG0004616	2	1	1	1	1	0	1	7
OG0004617	2	1	0	1	1	1	1	7
OG0004618	2	1	1	2	0	1	0	7
OG0004619	3	1	1	1	0	1	0	7
OG0004620	2	0	1	1	1	1	1	7
OG0004621	1	1	1	1	1	1	1	7
OG0004622	2	0	2	3	0	0	0	7
OG0004623	1	5	1	0	0	0	0	7
OG0004624	2	1	1	1	0	0	2	7
OG0004625	2	1	1	1	1	0	1	7
OG0004626	3	1	1	1	0	1	0	7
OG0004627	1	1	1	1	1	1	1	7
OG0004628	4	1	1	1	0	0	0	7
OG0004629	2	1	1	1	0	1	1	7
OG0004630	2	1	1	1	0	1	1	7
OG0004631	1	2	2	2	0	0	0	7
OG0004632	7	0	0	0	0	0	0	7
OG0004633	2	1	1	1	0	1	1	7
OG0004634	1	1	1	1	1	1	1	7
OG0004635	2	1	0	1	1	1	1	7
OG0004636	2	1	1	1	1	0	1	7
OG0004637	3	1	1	1	0	1	0	7
OG0004638	2	1	1	1	0	1	1	7
OG0004639	2	1	1	1	1	0	1	7
OG0004640	7	0	0	0	0	0	0	7
OG0004641	2	0	4	1	0	0	0	7
OG0004642	1	1	1	1	0	1	2	7
OG0004643	2	1	1	1	0	1	1	7
OG0004644	3	1	1	1	0	1	0	7
OG0004645	1	1	1	1	1	1	1	7
OG0004646	2	0	0	0	1	1	3	7
OG0004647	2	1	1	1	1	1	0	7
OG0004648	2	2	1	1	0	1	0	7
OG0004649	2	0	1	2	1	1	0	7
OG0004650	1	1	1	1	1	1	1	7
OG0004651	2	1	2	1	0	1	0	7
OG0004652	2	1	1	1	1	0	1	7
OG0004653	1	1	1	1	1	1	1	7
OG0004654	1	3	1	1	0	1	0	7
OG0004655	2	1	1	1	1	0	1	7
OG0004656	2	1	0	1	1	1	1	7
OG0004657	1	1	1	1	1	1	1	7
OG0004658	1	1	1	1	1	1	1	7
OG0004659	2	1	1	2	0	1	0	7
OG0004660	2	1	1	2	0	1	0	7
OG0004661	7	0	0	0	0	0	0	7
OG0004662	6	0	1	0	0	0	0	7
OG0004663	2	1	1	1	0	2	0	7
OG0004664	2	1	1	0	1	1	1	7
OG0004665	2	1	1	1	0	2	0	7
OG0004666	2	1	1	1	1	0	1	7
OG0004667	2	1	1	1	0	1	1	7
OG0004668	2	1	0	1	1	1	1	7
OG0004669	2	1	1	1	0	1	1	7
OG0004670	2	1	1	1	0	0	2	7
OG0004671	3	1	1	1	0	1	0	7
OG0004672	1	1	1	1	1	1	1	7
OG0004673	7	0	0	0	0	0	0	7
OG0004674	2	1	1	1	1	0	1	7
OG0004675	2	1	1	3	0	0	0	7
OG0004676	2	1	1	1	0	1	1	7
OG0004677	2	1	1	0	1	1	1	7
OG0004678	2	1	1	0	1	1	1	7
OG0004679	2	1	1	1	0	1	1	7
OG0004680	2	1	1	1	1	0	1	7
OG0004681	2	2	1	1	0	1	0	7
OG0004682	2	1	1	1	1	1	0	7
OG0004683	2	1	1	0	1	1	1	7
OG0004684	3	1	1	1	0	1	0	7
OG0004685	2	1	1	1	0	2	0	7
OG0004686	2	4	1	0	0	0	0	7
OG0004687	2	1	1	0	1	1	1	7
OG0004688	2	1	1	3	0	0	0	7
OG0004689	2	1	1	1	1	0	1	7
OG0004690	2	1	1	1	1	0	1	7
OG0004691	3	1	1	1	0	1	0	7
OG0004692	3	0	1	0	1	1	1	7
OG0004693	2	1	1	1	1	0	1	7
OG0004694	3	0	0	1	1	1	1	7
OG0004695	2	1	1	0	1	1	1	7
OG0004696	2	1	0	1	1	1	1	7
OG0004697	2	1	1	1	0	1	1	7
OG0004698	2	1	1	1	0	1	1	7
OG0004699	3	1	1	1	0	1	0	7
OG0004700	2	1	1	1	1	0	1	7
OG0004701	3	1	1	1	0	1	0	7
OG0004702	2	1	1	1	1	1	0	7
OG0004703	2	1	1	1	0	1	1	7
OG0004704	3	1	1	1	0	1	0	7
OG0004705	4	1	1	1	0	0	0	7
OG0004706	2	1	1	0	1	1	1	7
OG0004707	2	1	1	1	1	1	0	7
OG0004708	1	1	1	1	1	1	1	7
OG0004709	1	1	1	1	1	1	1	7
OG0004710	1	1	1	1	1	1	1	7
OG0004711	1	1	1	1	1	1	1	7
OG0004712	2	1	1	1	1	0	1	7
OG0004713	2	1	1	1	0	1	1	7
OG0004714	2	1	0	1	1	1	1	7
OG0004715	2	1	1	1	0	2	0	7
OG0004716	2	1	1	1	1	1	0	7
OG0004717	7	0	0	0	0	0	0	7
OG0004718	1	1	1	1	1	1	1	7
OG0004719	2	1	1	2	0	1	0	7
OG0004720	4	0	1	1	0	1	0	7
OG0004721	2	1	1	2	0	1	0	7
OG0004722	1	2	4	0	0	0	0	7
OG0004723	2	1	1	1	1	0	1	7
OG0004724	2	1	1	2	0	1	0	7
OG0004725	3	1	1	1	0	1	0	7
OG0004726	2	1	1	1	0	1	1	7
OG0004727	3	1	1	1	0	1	0	7
OG0004728	2	1	1	1	0	1	1	7
OG0004729	1	1	1	1	1	1	1	7
OG0004730	2	1	2	1	0	1	0	7
OG0004731	2	1	1	1	0	1	1	7
OG0004732	3	2	1	1	0	0	0	7
OG0004733	1	1	1	1	1	1	1	7
OG0004734	1	1	1	1	1	1	1	7
OG0004735	1	1	1	1	1	1	1	7
OG0004736	1	1	1	1	1	1	1	7
OG0004737	3	1	1	1	0	0	1	7
OG0004738	3	1	1	1	0	1	0	7
OG0004739	2	1	1	1	0	2	0	7
OG0004740	2	1	2	1	0	1	0	7
OG0004741	2	1	1	1	0	1	1	7
OG0004742	2	1	0	1	1	1	1	7
OG0004743	3	1	1	0	0	1	1	7
OG0004744	2	1	1	1	0	1	1	7
OG0004745	4	1	1	1	0	0	0	7
OG0004746	7	0	0	0	0	0	0	7
OG0004747	3	1	1	1	0	1	0	7
OG0004748	2	1	1	0	1	1	1	7
OG0004749	3	1	1	1	0	0	1	7
OG0004750	1	1	2	1	1	0	1	7
OG0004751	3	1	1	1	0	1	0	7
OG0004752	3	1	1	1	0	1	0	7
OG0004753	2	1	1	1	1	0	1	7
OG0004754	2	1	2	1	0	1	0	7
OG0004755	3	1	1	1	0	1	0	7
OG0004756	2	1	1	2	0	1	0	7
OG0004757	2	1	1	1	0	2	0	7
OG0004758	2	1	1	1	0	1	1	7
OG0004759	3	1	1	1	0	1	0	7
OG0004760	7	0	0	0	0	0	0	7
OG0004761	3	1	2	1	0	0	0	7
OG0004762	2	1	1	1	1	0	1	7
OG0004763	1	1	1	1	1	1	1	7
OG0004764	1	1	1	1	1	1	1	7
OG0004765	3	1	1	1	0	1	0	7
OG0004766	2	0	3	1	0	1	0	7
OG0004767	2	1	1	1	0	1	1	7
OG0004768	2	1	1	1	0	1	1	7
OG0004769	2	1	1	1	0	0	2	7
OG0004770	2	1	1	2	0	1	0	7
OG0004771	2	1	1	1	0	1	1	7
OG0004772	2	0	1	1	0	1	2	7
OG0004773	2	1	1	1	0	1	1	7
OG0004774	2	1	1	1	1	0	1	7
OG0004775	2	1	1	0	1	1	1	7
OG0004776	1	1	1	1	0	2	1	7
OG0004777	2	1	1	1	0	1	1	7
OG0004778	2	1	1	1	1	1	0	7
OG0004779	1	1	1	1	1	1	1	7
OG0004780	3	1	1	1	0	0	1	7
OG0004781	2	1	1	1	1	0	1	7
OG0004782	3	1	1	1	0	1	0	7
OG0004783	2	1	0	1	1	1	1	7
OG0004784	2	1	1	1	1	1	0	7
OG0004785	2	1	1	1	0	1	1	7
OG0004786	2	1	1	1	1	0	1	7
OG0004787	2	1	1	1	0	1	1	7
OG0004788	3	1	1	1	0	1	0	7
OG0004789	2	1	1	1	1	0	1	7
OG0004790	2	1	1	1	1	0	1	7
OG0004791	2	1	2	1	0	1	0	7
OG0004792	3	1	1	1	0	1	0	7
OG0004793	2	1	1	1	1	0	1	7
OG0004794	2	1	1	1	0	1	1	7
OG0004795	2	1	1	1	0	1	1	7
OG0004796	2	1	1	2	0	1	0	7
OG0004797	2	1	1	1	1	1	0	7
OG0004798	2	1	1	1	0	1	1	7
OG0004799	2	1	1	1	0	1	1	7
OG0004800	2	3	1	1	0	0	0	7
OG0004801	1	1	1	1	1	1	1	7
OG0004802	1	1	1	1	1	1	1	7
OG0004803	2	1	1	1	1	1	0	7
OG0004804	4	1	1	1	0	0	0	7
OG0004805	2	1	1	1	0	1	1	7
OG0004806	2	1	1	1	1	0	1	7
OG0004807	3	1	1	1	0	1	0	7
OG0004808	2	2	1	1	0	1	0	7
OG0004809	1	1	1	1	1	1	1	7
OG0004810	4	1	1	1	0	0	0	7
OG0004811	2	0	5	0	0	0	0	7
OG0004812	3	1	1	1	0	0	1	7
OG0004813	2	1	1	1	0	1	1	7
OG0004814	2	1	0	1	1	1	1	7
OG0004815	2	1	1	1	0	2	0	7
OG0004816	2	1	2	2	0	0	0	7
OG0004817	1	1	1	1	1	1	1	7
OG0004818	2	1	1	1	1	1	0	7
OG0004819	2	1	1	1	1	0	1	7
OG0004820	3	1	1	1	0	1	0	7
OG0004821	1	1	1	1	0	1	2	7
OG0004822	2	1	1	1	0	1	1	7
OG0004823	3	1	1	1	0	1	0	7
OG0004824	3	1	1	1	0	0	1	7
OG0004825	2	1	1	1	0	1	1	7
OG0004826	1	1	1	1	1	1	1	7
OG0004827	4	1	1	1	0	0	0	7
OG0004828	3	1	1	1	0	1	0	7
OG0004829	3	1	1	1	0	1	0	7
OG0004830	2	1	1	1	0	1	1	7
OG0004831	2	2	0	2	0	0	1	7
OG0004832	1	1	1	1	1	1	1	7
OG0004833	4	1	0	0	0	0	2	7
OG0004834	3	1	1	2	0	0	0	7
OG0004835	2	1	1	1	1	0	1	7
OG0004836	2	1	1	1	0	1	1	7
OG0004837	1	1	1	1	1	1	1	7
OG0004838	2	1	1	2	0	1	0	7
OG0004839	2	0	0	1	3	0	1	7
OG0004840	4	1	1	1	0	0	0	7
OG0004841	3	0	1	0	1	1	1	7
OG0004842	2	1	1	1	1	0	1	7
OG0004843	3	1	1	1	0	1	0	7
OG0004844	2	1	0	1	0	1	2	7
OG0004845	1	1	1	1	1	1	1	7
OG0004846	3	1	1	1	0	1	0	7
OG0004847	4	1	1	1	0	0	0	7
OG0004848	2	1	1	1	0	1	1	7
OG0004849	2	1	1	1	0	1	1	7
OG0004850	2	1	1	1	0	1	1	7
OG0004851	2	1	1	1	0	1	1	7
OG0004852	2	1	1	1	0	1	1	7
OG0004853	1	1	1	1	1	1	1	7
OG0004854	2	1	1	1	1	1	0	7
OG0004855	3	1	1	2	0	0	0	7
OG0004856	3	2	1	1	0	0	0	7
OG0004857	2	1	1	1	0	2	0	7
OG0004858	4	1	1	1	0	0	0	7
OG0004859	2	1	1	1	0	1	1	7
OG0004860	2	2	0	1	0	2	0	7
OG0004861	2	1	1	1	0	1	1	7
OG0004862	2	1	0	1	0	1	2	7
OG0004863	3	1	1	1	0	1	0	7
OG0004864	2	1	1	1	1	0	1	7
OG0004865	2	1	1	1	0	1	1	7
OG0004866	2	1	1	2	0	1	0	7
OG0004867	2	0	1	1	1	1	1	7
OG0004868	2	1	1	1	0	1	1	7
OG0004869	3	1	1	1	0	1	0	7
OG0004870	4	1	1	1	0	0	0	7
OG0004871	2	1	1	1	1	0	1	7
OG0004872	2	0	0	1	2	1	1	7
OG0004873	1	1	1	1	1	1	1	7
OG0004874	2	1	1	0	1	1	1	7
OG0004875	1	1	1	1	1	1	1	7
OG0004876	2	1	0	1	1	1	1	7
OG0004877	3	1	2	1	0	0	0	7
OG0004878	2	1	0	1	1	1	1	7
OG0004879	3	1	1	1	0	1	0	7
OG0004880	1	1	1	1	1	1	1	7
OG0004881	2	1	1	1	0	1	1	7
OG0004882	2	0	1	1	1	1	1	7
OG0004883	1	1	1	1	1	1	1	7
OG0004884	2	1	1	1	0	1	1	7
OG0004885	7	0	0	0	0	0	0	7
OG0004886	2	1	1	1	0	1	1	7
OG0004887	2	1	1	1	0	1	1	7
OG0004888	2	1	1	2	0	1	0	7
OG0004889	2	1	1	1	0	1	1	7
OG0004890	2	1	1	0	1	1	1	7
OG0004891	2	1	1	1	0	1	1	7
OG0004892	2	1	1	2	0	1	0	7
OG0004893	2	1	1	1	0	1	1	7
OG0004894	3	1	1	1	0	1	0	7
OG0004895	2	0	1	1	1	1	1	7
OG0004896	2	0	1	1	1	1	1	7
OG0004897	2	1	1	1	0	1	1	7
OG0004898	1	1	1	1	1	1	1	7
OG0004899	1	1	1	1	1	1	1	7
OG0004900	2	1	1	1	0	1	1	7
OG0004901	2	0	1	1	1	1	1	7
OG0004902	2	1	1	2	0	1	0	7
OG0004903	2	1	0	1	1	1	1	7
OG0004904	2	0	1	1	1	1	1	7
OG0004905	1	1	1	1	1	1	1	7
OG0004906	2	1	1	1	0	1	1	7
OG0004907	2	2	1	1	0	1	0	7
OG0004908	2	1	1	2	0	1	0	7
OG0004909	2	1	1	1	1	0	1	7
OG0004910	2	0	0	0	1	0	4	7
OG0004911	2	1	1	0	1	1	1	7
OG0004912	2	1	1	2	0	1	0	7
OG0004913	1	1	1	1	1	1	1	7
OG0004914	1	2	1	1	1	1	0	7
OG0004915	2	1	1	0	1	1	1	7
OG0004916	2	1	1	1	0	2	0	7
OG0004917	7	0	0	0	0	0	0	7
OG0004918	2	1	1	1	0	1	1	7
OG0004919	3	1	1	2	0	0	0	7
OG0004920	2	1	1	1	1	0	1	7
OG0004921	1	1	1	1	0	1	2	7
OG0004922	3	1	2	1	0	0	0	7
OG0004923	2	0	1	2	0	1	1	7
OG0004924	1	1	1	1	1	1	1	7
OG0004925	2	1	1	1	1	1	0	7
OG0004926	2	1	1	2	0	1	0	7
OG0004927	3	1	1	1	0	1	0	7
OG0004928	2	1	1	1	0	1	1	7
OG0004929	2	1	1	1	1	0	1	7
OG0004930	3	1	1	1	0	1	0	7
OG0004931	2	0	1	1	1	1	1	7
OG0004932	2	1	1	1	1	0	1	7
OG0004933	2	1	1	0	1	1	1	7
OG0004934	2	1	1	1	0	1	1	7
OG0004935	2	1	1	0	1	1	1	7
OG0004936	2	2	1	0	0	2	0	7
OG0004937	1	1	1	1	1	1	1	7
OG0004938	2	1	1	1	0	1	1	7
OG0004939	2	1	1	1	0	2	0	7
OG0004940	3	1	1	1	0	1	0	7
OG0004941	2	1	1	1	1	0	1	7
OG0004942	2	1	1	1	0	1	1	7
OG0004943	2	1	0	1	1	1	1	7
OG0004944	1	1	1	1	0	1	2	7
OG0004945	1	1	1	1	1	1	1	7
OG0004946	1	1	0	3	1	0	1	7
OG0004947	1	1	1	1	1	1	1	7
OG0004948	1	2	1	1	0	1	1	7
OG0004949	3	1	1	1	0	1	0	7
OG0004950	4	1	1	1	0	0	0	7
OG0004951	2	1	1	1	0	1	1	7
OG0004952	2	1	1	1	0	1	1	7
OG0004953	3	2	0	2	0	0	0	7
OG0004954	3	1	1	1	0	1	0	7
OG0004955	2	1	1	1	1	0	1	7
OG0004956	2	1	1	1	0	1	1	7
OG0004957	2	1	1	1	0	1	1	7
OG0004958	3	1	1	1	0	1	0	7
OG0004959	2	1	1	1	0	1	1	7
OG0004960	3	1	1	2	0	0	0	7
OG0004961	3	1	1	1	1	0	0	7
OG0004962	1	1	1	1	1	1	1	7
OG0004963	3	1	1	1	0	1	0	7
OG0004964	1	1	1	1	1	1	1	7
OG0004965	1	1	1	1	1	1	1	7
OG0004966	1	1	1	1	1	1	1	7
OG0004967	1	1	1	1	1	1	1	7
OG0004968	1	1	1	1	1	1	1	7
OG0004969	3	1	1	1	0	1	0	7
OG0004970	4	1	1	1	0	0	0	7
OG0004971	1	1	1	1	1	1	1	7
OG0004972	2	1	1	1	1	1	0	7
OG0004973	1	1	1	1	1	1	1	7
OG0004974	2	1	1	1	1	1	0	7
OG0004975	3	1	2	1	0	0	0	7
OG0004976	3	1	1	1	0	1	0	7
OG0004977	2	1	1	1	0	1	1	7
OG0004978	4	1	1	1	0	0	0	7
OG0004979	1	1	1	1	1	1	1	7
OG0004980	1	1	1	1	1	1	1	7
OG0004981	2	1	1	1	0	1	1	7
OG0004982	1	1	1	1	1	1	1	7
OG0004983	1	1	1	1	1	1	1	7
OG0004984	1	1	1	1	1	1	1	7
OG0004985	1	1	1	1	1	1	1	7
OG0004986	3	1	1	1	0	1	0	7
OG0004987	2	1	1	1	0	1	1	7
OG0004988	1	1	1	1	1	1	1	7
OG0004989	1	1	1	1	1	1	1	7
OG0004990	1	1	1	1	1	1	1	7
OG0004991	2	1	1	1	0	2	0	7
OG0004992	2	1	0	1	2	1	0	7
OG0004993	3	1	1	0	0	1	1	7
OG0004994	2	1	1	2	0	1	0	7
OG0004995	1	1	1	1	1	1	1	7
OG0004996	1	1	1	1	1	1	1	7
OG0004997	7	0	0	0	0	0	0	7
OG0004998	2	1	1	1	0	1	1	7
OG0004999	2	1	0	1	1	1	1	7
OG0005000	2	1	1	1	0	2	0	7
OG0005001	2	0	1	1	1	1	1	7
OG0005002	2	1	1	0	1	1	1	7
OG0005003	2	1	1	2	0	1	0	7
OG0005004	2	1	1	1	0	1	1	7
OG0005005	2	1	1	2	0	1	0	7
OG0005006	1	1	1	1	1	1	1	7
OG0005007	3	2	1	1	0	0	0	7
OG0005008	3	1	1	1	0	1	0	7
OG0005009	2	1	1	2	0	1	0	7
OG0005010	2	1	1	1	0	1	1	7
OG0005011	2	1	0	1	1	1	1	7
OG0005012	2	1	1	1	1	0	1	7
OG0005013	2	1	1	1	1	0	1	7
OG0005014	2	0	4	1	0	0	0	7
OG0005015	2	1	1	2	0	0	1	7
OG0005016	3	1	1	1	1	0	0	7
OG0005017	2	1	1	2	0	1	0	7
OG0005018	2	0	1	1	1	1	1	7
OG0005019	2	1	1	1	0	1	1	7
OG0005020	2	1	1	1	0	1	1	7
OG0005021	2	1	1	1	0	1	1	7
OG0005022	1	1	1	1	1	1	1	7
OG0005023	1	1	1	1	1	1	1	7
OG0005024	3	1	1	1	0	1	0	7
OG0005025	2	0	1	0	2	1	1	7
OG0005026	1	1	1	1	1	1	1	7
OG0005027	1	1	1	1	1	1	1	7
OG0005028	1	1	1	1	1	1	1	7
OG0005029	2	1	1	1	0	1	1	7
OG0005030	2	1	1	1	0	2	0	7
OG0005031	2	1	1	1	1	1	0	7
OG0005032	2	1	0	1	1	0	2	7
OG0005033	1	1	1	0	1	1	2	7
OG0005034	2	1	1	1	0	1	1	7
OG0005035	2	1	1	1	0	1	1	7
OG0005036	2	1	1	1	1	0	1	7
OG0005037	1	1	1	1	1	1	1	7
OG0005038	2	1	1	1	0	1	1	7
OG0005039	2	1	1	1	0	1	1	7
OG0005040	3	1	1	1	0	1	0	7
OG0005041	4	1	1	1	0	0	0	7
OG0005042	2	1	0	1	1	1	1	7
OG0005043	2	1	4	0	0	0	0	7
OG0005044	2	1	1	2	0	1	0	7
OG0005045	3	0	0	0	1	2	1	7
OG0005046	3	2	1	1	0	0	0	7
OG0005047	2	1	1	1	1	1	0	7
OG0005048	2	1	1	2	0	1	0	7
OG0005049	4	1	1	1	0	0	0	7
OG0005050	3	1	1	1	0	1	0	7
OG0005051	1	1	0	1	2	1	1	7
OG0005052	1	1	1	1	1	1	1	7
OG0005053	1	1	1	1	2	1	0	7
OG0005054	1	1	1	1	1	1	1	7
OG0005055	3	1	1	1	0	1	0	7
OG0005056	2	1	2	1	0	1	0	7
OG0005057	3	1	1	1	0	1	0	7
OG0005058	2	1	1	1	0	2	0	7
OG0005059	2	1	1	1	1	1	0	7
OG0005060	2	1	1	2	0	1	0	7
OG0005061	2	1	1	1	1	0	1	7
OG0005062	1	1	1	1	1	1	1	7
OG0005063	1	1	1	1	1	1	1	7
OG0005064	2	1	1	1	0	1	1	7
OG0005065	1	1	1	1	1	1	1	7
OG0005066	2	1	1	1	0	1	1	7
OG0005067	2	1	1	0	1	1	1	7
OG0005068	1	1	1	1	1	1	1	7
OG0005069	2	1	1	1	0	1	1	7
OG0005070	1	1	1	1	1	1	1	7
OG0005071	1	1	1	1	1	1	1	7
OG0005072	1	1	1	1	1	1	1	7
OG0005073	2	1	1	1	1	0	1	7
OG0005074	2	1	1	1	0	1	1	7
OG0005075	1	1	1	1	1	1	1	7
OG0005076	1	1	1	1	1	1	1	7
OG0005077	1	1	0	1	0	4	0	7
OG0005078	2	1	1	1	0	2	0	7
OG0005079	1	1	1	1	1	1	1	7
OG0005080	1	1	1	1	1	1	1	7
OG0005081	1	1	1	1	1	1	1	7
OG0005082	1	1	1	2	0	1	1	7
OG0005083	1	1	1	2	0	1	1	7
OG0005084	0	7	0	0	0	0	0	7
OG0005085	0	7	0	0	0	0	0	7
OG0005086	0	2	2	2	0	0	1	7
OG0005087	0	1	0	0	0	1	5	7
OG0005088	0	2	1	3	0	0	1	7
OG0005089	0	1	1	1	2	1	1	7
OG0005090	0	7	0	0	0	0	0	7
OG0005091	0	1	1	1	2	1	1	7
OG0005092	0	7	0	0	0	0	0	7
OG0005093	0	1	1	1	1	1	2	7
OG0005094	0	6	1	0	0	0	0	7
OG0005095	0	1	1	1	1	2	1	7
OG0005096	0	5	0	0	0	0	2	7
OG0005097	0	1	1	1	1	2	1	7
OG0005098	0	1	1	1	2	1	1	7
OG0005099	0	1	1	2	1	1	1	7
OG0005100	0	2	1	1	1	1	1	7
OG0005101	0	1	1	1	4	0	0	7
OG0005102	0	1	1	1	1	1	2	7
OG0005103	0	1	1	4	0	1	0	7
OG0005104	0	1	1	4	0	1	0	7
OG0005105	0	1	1	1	2	0	2	7
OG0005106	0	1	1	5	0	0	0	7
OG0005107	0	2	0	5	0	0	0	7
OG0005108	0	1	5	1	0	0	0	7
OG0005109	0	0	7	0	0	0	0	7
OG0005110	0	0	7	0	0	0	0	7
OG0005111	0	0	6	1	0	0	0	7
OG0005112	0	0	7	0	0	0	0	7
OG0005113	0	0	7	0	0	0	0	7
OG0005114	0	0	6	1	0	0	0	7
OG0005115	0	0	5	2	0	0	0	7
OG0005116	0	0	7	0	0	0	0	7
OG0005117	0	0	7	0	0	0	0	7
OG0005118	0	0	1	6	0	0	0	7
OG0005119	0	0	1	1	2	1	2	7
OG0005120	0	0	5	0	1	0	1	7
OG0005121	0	0	7	0	0	0	0	7
OG0005122	0	0	7	0	0	0	0	7
OG0005123	0	0	7	0	0	0	0	7
OG0005124	0	0	1	1	1	2	2	7
OG0005125	0	0	1	0	3	0	3	7
OG0005126	0	0	0	7	0	0	0	7
OG0005127	0	0	0	7	0	0	0	7
OG0005128	0	0	0	7	0	0	0	7
OG0005129	0	0	0	7	0	0	0	7
OG0005130	0	0	0	1	0	1	5	7
OG0005131	0	0	0	1	1	0	5	7
OG0005132	0	0	0	7	0	0	0	7
OG0005133	0	0	0	7	0	0	0	7
OG0005134	0	0	0	1	0	6	0	7
OG0005135	0	0	0	7	0	0	0	7
OG0005136	0	0	0	7	0	0	0	7
OG0005137	0	0	0	7	0	0	0	7
OG0005138	0	0	0	7	0	0	0	7
OG0005139	0	0	0	7	0	0	0	7
OG0005140	0	0	0	1	2	0	4	7
OG0005141	0	0	0	5	0	2	0	7
OG0005142	0	0	0	7	0	0	0	7
OG0005143	0	0	0	7	0	0	0	7
OG0005144	0	0	0	0	6	0	1	7
OG0005145	0	0	0	0	7	0	0	7
OG0005146	0	0	0	0	5	0	2	7
OG0005147	0	0	0	0	7	0	0	7
OG0005148	0	0	0	0	6	0	1	7
OG0005149	0	0	0	0	6	0	1	7
OG0005150	0	0	0	0	1	0	6	7
OG0005151	0	0	0	0	2	1	4	7
OG0005152	0	0	0	0	2	1	4	7
OG0005153	0	0	0	0	4	0	3	7
OG0005154	0	0	0	0	1	0	6	7
OG0005155	0	0	0	0	3	2	2	7
OG0005156	0	0	0	0	3	0	4	7
OG0005157	0	0	0	0	6	0	1	7
OG0005158	0	0	0	0	5	0	2	7
OG0005159	0	0	0	0	7	0	0	7
OG0005160	0	0	0	0	5	1	1	7
OG0005161	0	0	0	0	2	0	5	7
OG0005162	0	0	0	0	4	0	3	7
OG0005163	0	0	0	0	5	0	2	7
OG0005164	0	0	0	0	1	3	3	7
OG0005165	0	0	0	0	1	0	6	7
OG0005166	0	0	0	0	4	1	2	7
OG0005167	0	0	0	0	1	0	6	7
OG0005168	0	0	0	0	2	0	5	7
OG0005169	0	0	0	0	7	0	0	7
OG0005170	0	0	0	0	4	0	3	7
OG0005171	0	0	0	0	2	0	5	7
OG0005172	0	0	0	0	2	1	4	7
OG0005173	0	0	0	0	2	0	5	7
OG0005174	0	0	0	0	1	0	6	7
OG0005175	0	0	0	0	1	0	6	7
OG0005176	0	0	0	0	4	0	3	7
OG0005177	0	0	0	0	1	0	6	7
OG0005178	0	0	0	0	1	1	5	7
OG0005179	0	0	0	0	1	1	5	7
OG0005180	0	0	0	0	1	0	6	7
OG0005181	0	0	0	0	1	0	6	7
OG0005182	0	0	0	0	1	0	6	7
OG0005183	0	0	0	0	2	2	3	7
OG0005184	0	0	0	0	1	0	6	7
OG0005185	0	0	0	0	1	0	6	7
OG0005186	0	0	0	0	0	7	0	7
OG0005187	0	0	0	0	0	7	0	7
OG0005188	0	0	0	0	0	5	2	7
OG0005189	0	0	0	0	0	7	0	7
OG0005190	0	0	0	0	0	7	0	7
OG0005191	0	0	0	0	0	7	0	7
OG0005192	0	0	0	0	0	7	0	7
OG0005193	0	0	0	0	0	7	0	7
OG0005194	0	0	0	0	0	7	0	7
OG0005195	0	0	0	0	0	7	0	7
OG0005196	0	0	0	0	0	7	0	7
OG0005197	0	0	0	0	0	7	0	7
OG0005198	0	0	0	0	0	7	0	7
OG0005199	0	0	0	0	0	4	3	7
OG0005200	0	0	0	0	0	7	0	7
OG0005201	0	0	0	0	0	7	0	7
OG0005202	0	0	0	0	0	1	6	7
OG0005203	0	0	0	0	0	7	0	7
OG0005204	0	0	0	0	0	7	0	7
OG0005205	0	0	0	0	0	7	0	7
OG0005206	0	0	0	0	0	7	0	7
OG0005207	0	0	0	0	0	0	7	7
OG0005208	0	0	0	0	0	0	7	7
OG0005209	0	0	0	0	0	0	7	7
OG0005210	0	0	0	0	0	0	7	7
OG0005211	0	0	0	0	0	0	7	7
OG0005212	0	0	0	0	0	0	7	7
OG0005213	0	0	0	0	0	0	7	7
OG0005214	0	0	0	0	0	0	7	7
OG0005215	0	0	0	0	0	0	7	7
OG0005216	0	0	0	0	0	0	7	7
OG0005217	0	0	0	0	0	0	7	7
OG0005218	0	0	0	0	0	0	7	7
OG0005219	0	0	0	0	0	0	7	7
OG0005220	0	0	0	0	0	0	7	7
OG0005221	0	0	0	0	0	0	7	7
OG0005222	0	0	0	0	0	0	7	7
OG0005223	0	0	0	0	0	0	7	7
OG0005224	0	0	0	0	0	0	7	7
OG0005225	0	0	0	0	0	0	7	7
OG0005226	0	0	0	0	0	0	7	7
OG0005227	0	0	0	0	0	0	7	7
OG0005228	0	0	0	0	0	0	7	7
OG0005229	0	0	0	0	0	0	7	7
OG0005230	0	0	0	0	0	0	7	7
OG0005231	0	0	0	0	0	0	7	7
OG0005232	0	0	0	0	0	0	7	7
OG0005233	0	0	0	0	0	0	7	7
OG0005234	0	0	0	0	0	0	7	7
OG0005235	0	0	0	0	0	0	7	7
OG0005236	0	0	0	0	0	0	7	7
OG0005237	0	0	0	0	0	0	7	7
OG0005238	0	0	0	0	0	0	7	7
OG0005239	0	0	0	0	0	0	7	7
OG0005240	0	0	0	0	0	0	7	7
OG0005241	0	0	0	0	0	0	7	7
OG0005242	0	0	0	0	0	0	7	7
OG0005243	0	0	0	0	0	0	7	7
OG0005244	0	0	0	0	0	0	7	7
OG0005245	0	0	0	0	0	0	7	7
OG0005246	0	0	0	0	0	0	7	7
OG0005247	0	0	0	0	0	0	7	7
OG0005248	6	0	0	0	0	0	0	6
OG0005249	2	1	1	1	0	1	0	6
OG0005250	6	0	0	0	0	0	0	6
OG0005251	3	1	1	0	0	1	0	6
OG0005252	6	0	0	0	0	0	0	6
OG0005253	2	1	1	1	0	1	0	6
OG0005254	2	1	1	1	0	1	0	6
OG0005255	2	1	1	1	0	1	0	6
OG0005256	6	0	0	0	0	0	0	6
OG0005257	3	0	0	0	1	1	1	6
OG0005258	2	1	1	1	0	1	0	6
OG0005259	3	1	1	0	0	1	0	6
OG0005260	2	1	1	1	0	1	0	6
OG0005261	2	1	1	1	0	1	0	6
OG0005262	2	1	1	1	0	1	0	6
OG0005263	2	1	1	1	0	1	0	6
OG0005264	2	1	0	1	0	1	1	6
OG0005265	2	1	1	1	0	1	0	6
OG0005266	2	1	1	1	0	1	0	6
OG0005267	2	1	1	1	0	1	0	6
OG0005268	3	1	1	1	0	0	0	6
OG0005269	2	1	1	1	0	1	0	6
OG0005270	2	1	1	1	0	1	0	6
OG0005271	2	1	1	1	0	1	0	6
OG0005272	2	1	1	1	0	1	0	6
OG0005273	2	1	1	1	0	1	0	6
OG0005274	2	1	1	1	0	1	0	6
OG0005275	2	1	1	1	0	1	0	6
OG0005276	2	1	1	1	0	1	0	6
OG0005277	3	1	1	1	0	0	0	6
OG0005278	3	1	1	1	0	0	0	6
OG0005279	2	1	1	2	0	0	0	6
OG0005280	2	1	1	1	0	1	0	6
OG0005281	2	1	1	1	0	1	0	6
OG0005282	2	1	1	1	0	1	0	6
OG0005283	2	1	1	1	0	1	0	6
OG0005284	2	1	1	1	1	0	0	6
OG0005285	2	1	1	1	0	1	0	6
OG0005286	2	1	1	1	0	1	0	6
OG0005287	2	1	1	1	0	1	0	6
OG0005288	2	1	1	1	0	1	0	6
OG0005289	2	1	1	0	1	0	1	6
OG0005290	2	1	1	1	0	1	0	6
OG0005291	2	1	1	1	0	1	0	6
OG0005292	2	1	1	1	0	1	0	6
OG0005293	3	1	1	0	0	1	0	6
OG0005294	2	1	1	1	0	1	0	6
OG0005295	2	1	1	1	0	0	1	6
OG0005296	2	1	1	1	0	1	0	6
OG0005297	3	1	1	1	0	0	0	6
OG0005298	2	1	1	1	0	1	0	6
OG0005299	2	1	1	1	0	1	0	6
OG0005300	2	1	1	1	0	1	0	6
OG0005301	2	1	1	1	0	1	0	6
OG0005302	2	1	1	0	0	2	0	6
OG0005303	2	1	1	1	0	1	0	6
OG0005304	2	1	0	1	1	1	0	6
OG0005305	2	1	1	1	0	1	0	6
OG0005306	2	1	1	1	0	1	0	6
OG0005307	2	0	1	0	1	1	1	6
OG0005308	2	1	1	1	0	1	0	6
OG0005309	2	1	1	1	0	1	0	6
OG0005310	2	1	1	1	0	1	0	6
OG0005311	2	1	1	1	0	1	0	6
OG0005312	2	1	1	0	0	1	1	6
OG0005313	3	1	1	1	0	0	0	6
OG0005314	2	1	1	1	1	0	0	6
OG0005315	2	1	1	1	0	1	0	6
OG0005316	3	1	1	1	0	0	0	6
OG0005317	2	1	1	1	0	1	0	6
OG0005318	2	1	1	1	0	1	0	6
OG0005319	2	1	1	1	0	1	0	6
OG0005320	2	1	1	1	0	1	0	6
OG0005321	6	0	0	0	0	0	0	6
OG0005322	3	1	1	1	0	0	0	6
OG0005323	2	1	1	1	0	1	0	6
OG0005324	1	1	1	1	0	1	1	6
OG0005325	1	1	1	1	0	1	1	6
OG0005326	1	1	1	1	1	1	0	6
OG0005327	3	1	1	1	0	0	0	6
OG0005328	2	1	1	1	0	1	0	6
OG0005329	3	1	1	0	0	1	0	6
OG0005330	2	1	1	1	0	1	0	6
OG0005331	2	1	1	1	0	1	0	6
OG0005332	2	1	1	1	0	1	0	6
OG0005333	2	1	1	1	0	1	0	6
OG0005334	2	1	1	1	0	1	0	6
OG0005335	2	0	1	1	1	1	0	6
OG0005336	3	1	1	1	0	0	0	6
OG0005337	3	1	1	1	0	0	0	6
OG0005338	2	1	1	1	0	1	0	6
OG0005339	2	1	1	1	0	1	0	6
OG0005340	2	1	1	1	0	1	0	6
OG0005341	2	1	1	1	0	1	0	6
OG0005342	2	1	1	1	0	1	0	6
OG0005343	2	1	1	1	0	1	0	6
OG0005344	2	1	1	1	0	1	0	6
OG0005345	2	0	1	1	0	2	0	6
OG0005346	2	1	1	1	0	1	0	6
OG0005347	2	1	1	1	0	1	0	6
OG0005348	2	1	1	1	0	1	0	6
OG0005349	2	1	1	1	0	1	0	6
OG0005350	2	1	1	1	0	1	0	6
OG0005351	2	1	1	1	0	1	0	6
OG0005352	2	1	1	1	0	1	0	6
OG0005353	2	1	1	1	0	1	0	6
OG0005354	1	1	1	1	0	2	0	6
OG0005355	3	1	1	1	0	0	0	6
OG0005356	2	1	1	1	0	1	0	6
OG0005357	3	0	1	1	0	1	0	6
OG0005358	2	2	1	0	0	1	0	6
OG0005359	2	1	1	2	0	0	0	6
OG0005360	2	2	1	1	0	0	0	6
OG0005361	3	1	1	1	0	0	0	6
OG0005362	3	1	1	0	0	1	0	6
OG0005363	2	1	1	1	0	1	0	6
OG0005364	2	1	1	2	0	0	0	6
OG0005365	2	1	1	1	0	1	0	6
OG0005366	2	1	1	1	0	1	0	6
OG0005367	3	1	1	1	0	0	0	6
OG0005368	2	1	1	1	0	1	0	6
OG0005369	2	1	2	1	0	0	0	6
OG0005370	2	1	1	1	0	1	0	6
OG0005371	6	0	0	0	0	0	0	6
OG0005372	2	1	1	1	0	1	0	6
OG0005373	2	1	1	1	0	1	0	6
OG0005374	2	1	1	1	0	1	0	6
OG0005375	2	1	1	1	0	1	0	6
OG0005376	2	1	1	1	0	1	0	6
OG0005377	2	1	1	1	0	1	0	6
OG0005378	2	1	1	1	0	1	0	6
OG0005379	2	1	1	1	0	1	0	6
OG0005380	2	1	1	1	0	1	0	6
OG0005381	3	1	0	1	0	1	0	6
OG0005382	2	1	1	1	0	1	0	6
OG0005383	2	0	1	2	0	1	0	6
OG0005384	2	0	1	0	1	1	1	6
OG0005385	2	1	1	1	0	1	0	6
OG0005386	2	1	1	0	0	2	0	6
OG0005387	2	1	1	0	0	0	2	6
OG0005388	2	1	1	1	0	1	0	6
OG0005389	2	1	1	1	0	1	0	6
OG0005390	2	1	1	1	0	1	0	6
OG0005391	2	1	1	1	0	1	0	6
OG0005392	3	1	1	1	0	0	0	6
OG0005393	2	1	1	1	0	1	0	6
OG0005394	2	1	1	1	0	1	0	6
OG0005395	2	1	1	1	0	1	0	6
OG0005396	2	1	0	1	0	1	1	6
OG0005397	2	1	1	1	0	1	0	6
OG0005398	6	0	0	0	0	0	0	6
OG0005399	2	0	1	2	0	1	0	6
OG0005400	2	1	1	1	0	1	0	6
OG0005401	3	1	1	1	0	0	0	6
OG0005402	2	1	1	1	0	1	0	6
OG0005403	2	1	1	1	0	1	0	6
OG0005404	3	1	1	1	0	0	0	6
OG0005405	2	1	1	1	0	1	0	6
OG0005406	2	1	1	1	0	1	0	6
OG0005407	2	1	1	2	0	0	0	6
OG0005408	2	1	1	1	0	1	0	6
OG0005409	2	1	1	1	1	0	0	6
OG0005410	2	1	1	1	0	1	0	6
OG0005411	2	1	1	1	0	1	0	6
OG0005412	3	1	1	1	0	0	0	6
OG0005413	2	1	2	1	0	0	0	6
OG0005414	1	1	1	1	0	1	1	6
OG0005415	3	0	1	1	0	1	0	6
OG0005416	2	1	2	1	0	0	0	6
OG0005417	2	1	1	1	0	1	0	6
OG0005418	3	1	1	1	0	0	0	6
OG0005419	2	1	1	1	0	1	0	6
OG0005420	2	1	1	1	0	1	0	6
OG0005421	2	1	1	1	0	1	0	6
OG0005422	2	1	1	1	0	1	0	6
OG0005423	2	1	1	1	0	1	0	6
OG0005424	2	1	1	1	0	1	0	6
OG0005425	2	1	1	1	0	1	0	6
OG0005426	2	1	1	1	0	1	0	6
OG0005427	3	1	1	1	0	0	0	6
OG0005428	2	0	0	1	1	1	1	6
OG0005429	3	1	1	0	0	1	0	6
OG0005430	2	1	0	1	0	1	1	6
OG0005431	2	1	1	1	0	1	0	6
OG0005432	2	1	1	1	0	1	0	6
OG0005433	2	1	0	1	0	1	1	6
OG0005434	2	1	1	0	1	0	1	6
OG0005435	2	1	1	1	0	1	0	6
OG0005436	3	1	1	0	0	1	0	6
OG0005437	2	1	1	1	0	1	0	6
OG0005438	1	1	1	1	1	1	0	6
OG0005439	2	1	1	1	0	1	0	6
OG0005440	2	1	1	1	0	1	0	6
OG0005441	4	0	1	1	0	0	0	6
OG0005442	2	1	1	1	0	1	0	6
OG0005443	6	0	0	0	0	0	0	6
OG0005444	6	0	0	0	0	0	0	6
OG0005445	2	1	1	1	0	1	0	6
OG0005446	2	1	1	1	0	1	0	6
OG0005447	2	2	1	1	0	0	0	6
OG0005448	2	1	1	1	0	1	0	6
OG0005449	3	1	1	1	0	0	0	6
OG0005450	2	1	1	1	0	1	0	6
OG0005451	3	1	1	1	0	0	0	6
OG0005452	2	1	2	1	0	0	0	6
OG0005453	3	0	1	1	0	1	0	6
OG0005454	3	1	1	1	0	0	0	6
OG0005455	3	1	1	1	0	0	0	6
OG0005456	3	1	1	1	0	0	0	6
OG0005457	3	1	1	1	0	0	0	6
OG0005458	6	0	0	0	0	0	0	6
OG0005459	2	1	1	1	0	1	0	6
OG0005460	6	0	0	0	0	0	0	6
OG0005461	2	1	1	1	0	1	0	6
OG0005462	2	1	1	1	0	1	0	6
OG0005463	2	1	1	2	0	0	0	6
OG0005464	2	2	2	0	0	0	0	6
OG0005465	2	1	1	1	0	1	0	6
OG0005466	3	1	1	1	0	0	0	6
OG0005467	2	1	1	1	0	1	0	6
OG0005468	2	0	1	1	1	1	0	6
OG0005469	2	1	1	1	0	1	0	6
OG0005470	2	1	1	1	0	1	0	6
OG0005471	6	0	0	0	0	0	0	6
OG0005472	2	1	1	1	0	1	0	6
OG0005473	6	0	0	0	0	0	0	6
OG0005474	2	1	1	1	0	0	1	6
OG0005475	2	1	1	1	0	1	0	6
OG0005476	3	1	1	1	0	0	0	6
OG0005477	2	1	1	1	0	1	0	6
OG0005478	2	1	1	0	1	1	0	6
OG0005479	2	1	1	1	0	1	0	6
OG0005480	2	1	1	1	0	1	0	6
OG0005481	2	1	1	1	0	1	0	6
OG0005482	2	1	1	1	0	1	0	6
OG0005483	2	1	1	1	0	1	0	6
OG0005484	2	1	1	1	0	1	0	6
OG0005485	2	1	1	1	0	1	0	6
OG0005486	2	1	1	1	0	1	0	6
OG0005487	2	0	1	0	0	1	2	6
OG0005488	3	1	0	1	0	1	0	6
OG0005489	2	1	1	1	0	1	0	6
OG0005490	2	1	1	2	0	0	0	6
OG0005491	3	1	1	1	0	0	0	6
OG0005492	2	1	1	2	0	0	0	6
OG0005493	2	1	1	1	0	1	0	6
OG0005494	2	1	1	1	0	1	0	6
OG0005495	2	1	1	1	0	1	0	6
OG0005496	2	1	1	1	0	1	0	6
OG0005497	2	1	1	1	0	1	0	6
OG0005498	2	1	1	1	0	1	0	6
OG0005499	3	1	1	1	0	0	0	6
OG0005500	2	1	1	1	0	1	0	6
OG0005501	1	1	1	0	1	1	1	6
OG0005502	2	1	0	1	0	1	1	6
OG0005503	2	1	1	1	0	1	0	6
OG0005504	2	1	1	1	0	1	0	6
OG0005505	2	0	1	1	0	1	1	6
OG0005506	1	1	1	1	1	1	0	6
OG0005507	1	1	1	2	0	1	0	6
OG0005508	1	1	1	0	1	1	1	6
OG0005509	1	0	1	1	1	1	1	6
OG0005510	3	1	1	1	0	0	0	6
OG0005511	2	1	1	1	0	1	0	6
OG0005512	2	1	1	1	0	1	0	6
OG0005513	2	1	1	1	0	1	0	6
OG0005514	2	1	1	1	0	1	0	6
OG0005515	2	1	1	1	0	1	0	6
OG0005516	1	0	1	1	1	1	1	6
OG0005517	2	0	2	2	0	0	0	6
OG0005518	3	1	1	1	0	0	0	6
OG0005519	2	1	1	1	0	1	0	6
OG0005520	2	1	1	1	0	1	0	6
OG0005521	2	1	1	1	0	1	0	6
OG0005522	2	1	1	1	0	1	0	6
OG0005523	3	1	1	0	0	1	0	6
OG0005524	2	1	1	1	0	1	0	6
OG0005525	2	1	1	1	0	1	0	6
OG0005526	3	1	0	1	0	1	0	6
OG0005527	3	1	1	1	0	0	0	6
OG0005528	2	1	1	0	1	1	0	6
OG0005529	3	1	0	1	0	1	0	6
OG0005530	2	1	1	1	0	1	0	6
OG0005531	6	0	0	0	0	0	0	6
OG0005532	2	1	1	1	0	1	0	6
OG0005533	2	1	1	1	0	1	0	6
OG0005534	2	1	1	1	0	1	0	6
OG0005535	2	1	1	1	0	1	0	6
OG0005536	2	1	1	1	0	1	0	6
OG0005537	3	1	1	1	0	0	0	6
OG0005538	3	1	1	0	0	1	0	6
OG0005539	2	1	1	1	0	1	0	6
OG0005540	3	0	1	2	0	0	0	6
OG0005541	3	1	1	1	0	0	0	6
OG0005542	2	1	0	1	1	0	1	6
OG0005543	2	1	1	1	0	1	0	6
OG0005544	2	1	1	1	0	1	0	6
OG0005545	1	1	1	2	0	0	1	6
OG0005546	2	1	1	1	0	1	0	6
OG0005547	3	1	1	1	0	0	0	6
OG0005548	3	1	1	1	0	0	0	6
OG0005549	2	1	1	1	0	1	0	6
OG0005550	2	1	1	1	0	1	0	6
OG0005551	3	1	1	1	0	0	0	6
OG0005552	2	1	1	1	0	1	0	6
OG0005553	2	1	1	1	0	1	0	6
OG0005554	2	1	1	1	0	1	0	6
OG0005555	2	1	1	1	0	1	0	6
OG0005556	2	1	1	1	0	1	0	6
OG0005557	2	1	1	1	0	1	0	6
OG0005558	6	0	0	0	0	0	0	6
OG0005559	2	1	1	1	0	1	0	6
OG0005560	3	1	1	1	0	0	0	6
OG0005561	2	1	1	1	0	1	0	6
OG0005562	2	0	1	2	0	1	0	6
OG0005563	2	1	1	1	0	1	0	6
OG0005564	2	1	1	1	0	1	0	6
OG0005565	2	1	1	1	0	1	0	6
OG0005566	2	1	1	1	0	1	0	6
OG0005567	2	1	1	1	0	1	0	6
OG0005568	2	1	1	1	0	1	0	6
OG0005569	2	1	1	1	0	1	0	6
OG0005570	2	1	1	1	0	1	0	6
OG0005571	3	1	1	1	0	0	0	6
OG0005572	2	1	1	1	0	1	0	6
OG0005573	2	1	1	0	1	0	1	6
OG0005574	2	1	1	1	0	1	0	6
OG0005575	3	0	1	1	0	1	0	6
OG0005576	2	1	1	1	0	1	0	6
OG0005577	1	1	1	2	0	1	0	6
OG0005578	2	1	1	1	0	1	0	6
OG0005579	2	1	1	1	0	1	0	6
OG0005580	2	1	1	1	0	1	0	6
OG0005581	2	1	1	1	0	1	0	6
OG0005582	2	0	1	1	0	1	1	6
OG0005583	2	1	1	1	0	1	0	6
OG0005584	2	1	1	1	0	1	0	6
OG0005585	2	1	1	1	0	1	0	6
OG0005586	1	1	1	1	0	1	1	6
OG0005587	3	1	1	1	0	0	0	6
OG0005588	2	1	1	1	0	1	0	6
OG0005589	3	1	1	1	0	0	0	6
OG0005590	2	1	1	1	0	1	0	6
OG0005591	2	1	1	1	0	1	0	6
OG0005592	2	1	1	1	0	1	0	6
OG0005593	2	1	1	1	0	1	0	6
OG0005594	2	1	1	1	0	1	0	6
OG0005595	2	1	1	1	0	1	0	6
OG0005596	2	1	1	1	0	1	0	6
OG0005597	3	1	1	1	0	0	0	6
OG0005598	2	1	1	1	0	1	0	6
OG0005599	1	1	2	1	0	1	0	6
OG0005600	2	2	1	1	0	0	0	6
OG0005601	2	1	1	1	0	1	0	6
OG0005602	2	1	1	1	0	1	0	6
OG0005603	2	1	1	1	0	1	0	6
OG0005604	2	1	1	1	0	1	0	6
OG0005605	2	1	1	1	0	1	0	6
OG0005606	2	1	1	1	0	1	0	6
OG0005607	4	1	0	1	0	0	0	6
OG0005608	2	1	1	1	1	0	0	6
OG0005609	2	1	1	1	0	1	0	6
OG0005610	2	1	1	1	0	1	0	6
OG0005611	2	1	0	1	0	1	1	6
OG0005612	3	1	1	1	0	0	0	6
OG0005613	6	0	0	0	0	0	0	6
OG0005614	2	1	1	1	0	1	0	6
OG0005615	3	1	1	1	0	0	0	6
OG0005616	2	1	1	1	0	1	0	6
OG0005617	2	1	1	2	0	0	0	6
OG0005618	2	1	1	1	0	1	0	6
OG0005619	2	0	1	1	1	0	1	6
OG0005620	2	1	1	1	0	1	0	6
OG0005621	3	1	1	1	0	0	0	6
OG0005622	2	1	1	1	0	1	0	6
OG0005623	3	1	1	1	0	0	0	6
OG0005624	2	2	1	1	0	0	0	6
OG0005625	1	1	1	1	0	1	1	6
OG0005626	2	1	1	1	0	1	0	6
OG0005627	2	1	2	1	0	0	0	6
OG0005628	2	1	1	1	0	1	0	6
OG0005629	3	1	1	1	0	0	0	6
OG0005630	2	1	1	1	0	1	0	6
OG0005631	2	1	1	0	0	2	0	6
OG0005632	2	1	1	1	0	1	0	6
OG0005633	2	1	1	1	0	1	0	6
OG0005634	2	0	1	0	1	1	1	6
OG0005635	2	1	1	1	0	1	0	6
OG0005636	1	1	1	0	0	1	2	6
OG0005637	2	1	1	1	0	0	1	6
OG0005638	2	1	1	1	0	1	0	6
OG0005639	2	1	1	1	0	1	0	6
OG0005640	2	1	1	1	0	1	0	6
OG0005641	2	1	1	2	0	0	0	6
OG0005642	2	2	1	1	0	0	0	6
OG0005643	2	1	1	1	0	1	0	6
OG0005644	4	1	0	1	0	0	0	6
OG0005645	2	1	1	1	0	1	0	6
OG0005646	2	1	1	1	0	1	0	6
OG0005647	2	1	1	1	0	1	0	6
OG0005648	2	1	1	1	0	1	0	6
OG0005649	2	1	1	1	0	1	0	6
OG0005650	3	1	1	0	0	1	0	6
OG0005651	4	0	1	1	0	0	0	6
OG0005652	2	1	1	1	0	1	0	6
OG0005653	1	1	1	1	0	1	1	6
OG0005654	2	1	1	1	0	1	0	6
OG0005655	2	1	1	1	0	1	0	6
OG0005656	2	1	1	1	0	1	0	6
OG0005657	2	1	1	1	0	1	0	6
OG0005658	2	0	1	2	0	1	0	6
OG0005659	3	1	1	1	0	0	0	6
OG0005660	2	1	1	1	0	1	0	6
OG0005661	2	1	1	0	0	2	0	6
OG0005662	2	2	1	1	0	0	0	6
OG0005663	1	0	3	1	0	0	1	6
OG0005664	2	1	1	1	0	1	0	6
OG0005665	2	1	1	1	0	1	0	6
OG0005666	2	1	1	1	0	1	0	6
OG0005667	3	1	1	0	0	1	0	6
OG0005668	2	1	1	0	0	1	1	6
OG0005669	2	1	1	1	1	0	0	6
OG0005670	4	0	0	0	0	1	1	6
OG0005671	2	1	1	1	0	1	0	6
OG0005672	2	1	1	1	0	1	0	6
OG0005673	4	0	0	1	0	1	0	6
OG0005674	2	1	1	1	0	1	0	6
OG0005675	2	1	1	1	0	1	0	6
OG0005676	2	2	1	1	0	0	0	6
OG0005677	2	1	1	1	0	1	0	6
OG0005678	2	1	1	1	0	1	0	6
OG0005679	2	1	1	1	0	1	0	6
OG0005680	2	1	1	1	0	1	0	6
OG0005681	2	1	1	1	0	1	0	6
OG0005682	1	0	1	0	2	1	1	6
OG0005683	2	1	1	1	0	1	0	6
OG0005684	2	0	0	0	0	4	0	6
OG0005685	2	1	1	1	0	1	0	6
OG0005686	2	1	2	1	0	0	0	6
OG0005687	6	0	0	0	0	0	0	6
OG0005688	3	1	1	1	0	0	0	6
OG0005689	3	1	1	1	0	0	0	6
OG0005690	2	1	1	1	0	1	0	6
OG0005691	2	1	1	1	0	1	0	6
OG0005692	2	1	2	0	0	1	0	6
OG0005693	2	1	1	1	0	1	0	6
OG0005694	2	1	1	1	0	1	0	6
OG0005695	2	1	1	0	0	1	1	6
OG0005696	2	1	1	1	0	1	0	6
OG0005697	2	1	1	1	0	1	0	6
OG0005698	2	1	1	1	0	1	0	6
OG0005699	2	1	1	1	0	1	0	6
OG0005700	2	1	1	1	0	1	0	6
OG0005701	2	1	1	1	0	1	0	6
OG0005702	2	1	1	1	0	1	0	6
OG0005703	2	1	1	1	0	1	0	6
OG0005704	2	1	0	1	0	1	1	6
OG0005705	2	1	1	1	0	1	0	6
OG0005706	3	0	1	1	0	1	0	6
OG0005707	3	1	1	1	0	0	0	6
OG0005708	2	0	1	1	0	2	0	6
OG0005709	3	1	1	1	0	0	0	6
OG0005710	2	1	2	1	0	0	0	6
OG0005711	1	1	0	1	1	1	1	6
OG0005712	2	0	1	0	1	1	1	6
OG0005713	2	1	1	1	0	1	0	6
OG0005714	2	1	1	1	0	1	0	6
OG0005715	2	1	1	1	0	1	0	6
OG0005716	2	1	1	1	0	1	0	6
OG0005717	3	1	1	0	0	1	0	6
OG0005718	3	0	0	0	1	1	1	6
OG0005719	2	2	1	1	0	0	0	6
OG0005720	1	1	1	1	1	1	0	6
OG0005721	1	1	1	1	0	1	1	6
OG0005722	2	1	1	1	0	1	0	6
OG0005723	2	1	1	2	0	0	0	6
OG0005724	2	1	2	1	0	0	0	6
OG0005725	3	1	1	1	0	0	0	6
OG0005726	2	1	1	1	0	1	0	6
OG0005727	2	1	2	0	0	1	0	6
OG0005728	2	1	1	0	0	0	2	6
OG0005729	1	0	0	1	1	2	1	6
OG0005730	2	1	1	1	0	1	0	6
OG0005731	2	1	1	1	0	1	0	6
OG0005732	4	1	0	1	0	0	0	6
OG0005733	3	1	0	1	0	1	0	6
OG0005734	1	1	1	1	1	1	0	6
OG0005735	2	1	1	1	0	1	0	6
OG0005736	3	0	1	1	0	1	0	6
OG0005737	3	1	1	1	0	0	0	6
OG0005738	1	1	1	0	2	0	1	6
OG0005739	1	0	2	3	0	0	0	6
OG0005740	3	1	1	1	0	0	0	6
OG0005741	2	1	1	1	0	1	0	6
OG0005742	2	1	1	1	0	1	0	6
OG0005743	2	1	1	1	0	1	0	6
OG0005744	2	1	1	1	0	1	0	6
OG0005745	2	1	1	1	0	1	0	6
OG0005746	2	1	1	1	0	1	0	6
OG0005747	2	1	2	1	0	0	0	6
OG0005748	2	1	1	1	0	1	0	6
OG0005749	2	1	2	1	0	0	0	6
OG0005750	1	1	1	1	1	1	0	6
OG0005751	2	1	1	1	0	1	0	6
OG0005752	3	1	1	1	0	0	0	6
OG0005753	2	1	1	1	0	1	0	6
OG0005754	4	1	1	0	0	0	0	6
OG0005755	2	1	1	1	0	1	0	6
OG0005756	2	1	1	1	0	1	0	6
OG0005757	1	1	1	2	0	1	0	6
OG0005758	3	0	0	0	1	1	1	6
OG0005759	2	1	1	1	0	1	0	6
OG0005760	1	1	1	1	1	0	1	6
OG0005761	1	0	0	5	0	0	0	6
OG0005762	3	1	1	1	0	0	0	6
OG0005763	1	1	0	1	1	1	1	6
OG0005764	1	2	1	1	0	1	0	6
OG0005765	4	0	1	0	0	1	0	6
OG0005766	4	0	1	0	0	1	0	6
OG0005767	2	1	1	1	0	0	1	6
OG0005768	2	1	1	1	0	1	0	6
OG0005769	2	1	1	1	0	0	1	6
OG0005770	3	1	1	1	0	0	0	6
OG0005771	5	0	1	0	0	0	0	6
OG0005772	1	0	1	0	0	0	4	6
OG0005773	2	1	1	1	0	1	0	6
OG0005774	2	1	1	1	0	1	0	6
OG0005775	3	1	1	1	0	0	0	6
OG0005776	1	0	1	1	1	1	1	6
OG0005777	3	1	1	1	0	0	0	6
OG0005778	2	1	1	1	0	1	0	6
OG0005779	2	1	1	1	0	1	0	6
OG0005780	3	0	0	0	0	1	2	6
OG0005781	1	0	3	1	0	1	0	6
OG0005782	2	1	1	1	0	1	0	6
OG0005783	2	1	1	1	0	1	0	6
OG0005784	2	1	1	1	0	1	0	6
OG0005785	2	1	1	1	0	1	0	6
OG0005786	2	1	1	1	0	1	0	6
OG0005787	2	1	1	1	0	1	0	6
OG0005788	2	1	1	1	0	1	0	6
OG0005789	3	1	1	1	0	0	0	6
OG0005790	2	1	1	1	0	1	0	6
OG0005791	2	1	1	1	0	1	0	6
OG0005792	2	1	1	1	0	1	0	6
OG0005793	3	1	1	1	0	0	0	6
OG0005794	2	1	1	1	0	1	0	6
OG0005795	3	1	1	1	0	0	0	6
OG0005796	2	1	1	1	0	1	0	6
OG0005797	1	1	1	2	0	1	0	6
OG0005798	1	1	1	1	0	1	1	6
OG0005799	1	0	1	1	1	1	1	6
OG0005800	2	1	1	1	0	1	0	6
OG0005801	2	1	1	1	0	1	0	6
OG0005802	2	1	1	1	0	1	0	6
OG0005803	2	1	1	1	0	1	0	6
OG0005804	2	1	1	1	0	0	1	6
OG0005805	2	2	0	2	0	0	0	6
OG0005806	2	1	1	1	0	1	0	6
OG0005807	2	1	1	1	0	1	0	6
OG0005808	2	1	1	1	0	1	0	6
OG0005809	2	1	1	1	0	1	0	6
OG0005810	2	1	1	1	0	1	0	6
OG0005811	2	1	1	1	0	0	1	6
OG0005812	2	1	1	1	0	1	0	6
OG0005813	2	1	1	1	0	0	1	6
OG0005814	2	1	2	1	0	0	0	6
OG0005815	2	1	1	1	0	1	0	6
OG0005816	2	1	1	1	0	1	0	6
OG0005817	2	1	1	1	1	0	0	6
OG0005818	1	1	1	0	1	1	1	6
OG0005819	2	1	1	1	0	1	0	6
OG0005820	6	0	0	0	0	0	0	6
OG0005821	2	1	1	1	0	0	1	6
OG0005822	2	1	0	1	1	1	0	6
OG0005823	3	1	1	1	0	0	0	6
OG0005824	2	1	1	2	0	0	0	6
OG0005825	2	1	1	1	0	1	0	6
OG0005826	2	1	1	1	0	1	0	6
OG0005827	3	1	1	1	0	0	0	6
OG0005828	3	1	1	1	0	0	0	6
OG0005829	1	1	1	1	0	1	1	6
OG0005830	1	1	1	1	1	0	1	6
OG0005831	1	0	1	4	0	0	0	6
OG0005832	1	1	1	1	0	1	1	6
OG0005833	1	1	1	1	0	1	1	6
OG0005834	1	1	0	1	1	1	1	6
OG0005835	3	1	1	1	0	0	0	6
OG0005836	2	1	2	1	0	0	0	6
OG0005837	2	1	1	1	0	1	0	6
OG0005838	2	1	1	1	0	1	0	6
OG0005839	2	1	1	1	0	1	0	6
OG0005840	2	1	1	1	0	1	0	6
OG0005841	1	1	1	1	0	1	1	6
OG0005842	1	0	5	0	0	0	0	6
OG0005843	3	1	1	1	0	0	0	6
OG0005844	2	1	1	1	0	1	0	6
OG0005845	2	1	1	1	0	1	0	6
OG0005846	2	1	1	1	0	1	0	6
OG0005847	2	1	1	1	0	1	0	6
OG0005848	3	0	1	1	0	1	0	6
OG0005849	1	1	1	1	1	1	0	6
OG0005850	2	0	2	1	0	1	0	6
OG0005851	1	1	1	1	0	1	1	6
OG0005852	0	6	0	0	0	0	0	6
OG0005853	0	6	0	0	0	0	0	6
OG0005854	0	1	1	1	1	1	1	6
OG0005855	0	4	2	0	0	0	0	6
OG0005856	0	1	1	1	1	1	1	6
OG0005857	0	3	2	1	0	0	0	6
OG0005858	0	6	0	0	0	0	0	6
OG0005859	0	1	0	1	2	0	2	6
OG0005860	0	1	0	0	3	0	2	6
OG0005861	0	1	1	1	1	1	1	6
OG0005862	0	1	1	1	1	1	1	6
OG0005863	0	1	1	1	1	0	2	6
OG0005864	0	1	1	1	1	1	1	6
OG0005865	0	1	1	1	0	3	0	6
OG0005866	0	6	0	0	0	0	0	6
OG0005867	0	1	0	1	1	1	2	6
OG0005868	0	2	2	2	0	0	0	6
OG0005869	0	2	3	1	0	0	0	6
OG0005870	0	5	0	1	0	0	0	6
OG0005871	0	1	0	0	1	0	4	6
OG0005872	0	1	1	4	0	0	0	6
OG0005873	0	3	2	1	0	0	0	6
OG0005874	0	2	2	2	0	0	0	6
OG0005875	0	1	1	1	1	1	1	6
OG0005876	0	1	1	1	1	1	1	6
OG0005877	0	2	1	2	0	1	0	6
OG0005878	0	1	5	0	0	0	0	6
OG0005879	0	1	1	1	1	1	1	6
OG0005880	0	1	1	1	1	1	1	6
OG0005881	0	1	1	1	1	1	1	6
OG0005882	0	1	1	1	1	1	1	6
OG0005883	0	1	1	1	1	0	2	6
OG0005884	0	1	1	1	1	1	1	6
OG0005885	0	1	1	0	0	2	2	6
OG0005886	0	1	0	2	1	0	2	6
OG0005887	0	1	0	0	0	4	1	6
OG0005888	0	4	0	2	0	0	0	6
OG0005889	0	1	1	1	1	1	1	6
OG0005890	0	1	1	1	1	1	1	6
OG0005891	0	1	1	1	1	1	1	6
OG0005892	0	2	0	4	0	0	0	6
OG0005893	0	1	0	0	2	2	1	6
OG0005894	0	1	1	4	0	0	0	6
OG0005895	0	0	6	0	0	0	0	6
OG0005896	0	0	6	0	0	0	0	6
OG0005897	0	0	6	0	0	0	0	6
OG0005898	0	0	6	0	0	0	0	6
OG0005899	0	0	1	5	0	0	0	6
OG0005900	0	0	5	1	0	0	0	6
OG0005901	0	0	6	0	0	0	0	6
OG0005902	0	0	6	0	0	0	0	6
OG0005903	0	0	6	0	0	0	0	6
OG0005904	0	0	6	0	0	0	0	6
OG0005905	0	0	6	0	0	0	0	6
OG0005906	0	0	6	0	0	0	0	6
OG0005907	0	0	6	0	0	0	0	6
OG0005908	0	0	6	0	0	0	0	6
OG0005909	0	0	6	0	0	0	0	6
OG0005910	0	0	6	0	0	0	0	6
OG0005911	0	0	1	1	1	0	3	6
OG0005912	0	0	0	6	0	0	0	6
OG0005913	0	0	0	6	0	0	0	6
OG0005914	0	0	0	6	0	0	0	6
OG0005915	0	0	0	1	2	0	3	6
OG0005916	0	0	0	6	0	0	0	6
OG0005917	0	0	0	2	1	1	2	6
OG0005918	0	0	0	6	0	0	0	6
OG0005919	0	0	0	6	0	0	0	6
OG0005920	0	0	0	6	0	0	0	6
OG0005921	0	0	0	6	0	0	0	6
OG0005922	0	0	0	1	0	0	5	6
OG0005923	0	0	0	6	0	0	0	6
OG0005924	0	0	0	6	0	0	0	6
OG0005925	0	0	0	6	0	0	0	6
OG0005926	0	0	0	6	0	0	0	6
OG0005927	0	0	0	6	0	0	0	6
OG0005928	0	0	0	6	0	0	0	6
OG0005929	0	0	0	4	1	0	1	6
OG0005930	0	0	0	6	0	0	0	6
OG0005931	0	0	0	6	0	0	0	6
OG0005932	0	0	0	6	0	0	0	6
OG0005933	0	0	0	6	0	0	0	6
OG0005934	0	0	0	6	0	0	0	6
OG0005935	0	0	0	6	0	0	0	6
OG0005936	0	0	0	6	0	0	0	6
OG0005937	0	0	0	1	1	0	4	6
OG0005938	0	0	0	1	3	0	2	6
OG0005939	0	0	0	0	5	0	1	6
OG0005940	0	0	0	0	6	0	0	6
OG0005941	0	0	0	0	2	1	3	6
OG0005942	0	0	0	0	5	0	1	6
OG0005943	0	0	0	0	6	0	0	6
OG0005944	0	0	0	0	1	0	5	6
OG0005945	0	0	0	0	2	0	4	6
OG0005946	0	0	0	0	3	0	3	6
OG0005947	0	0	0	0	2	1	3	6
OG0005948	0	0	0	0	6	0	0	6
OG0005949	0	0	0	0	6	0	0	6
OG0005950	0	0	0	0	5	0	1	6
OG0005951	0	0	0	0	6	0	0	6
OG0005952	0	0	0	0	6	0	0	6
OG0005953	0	0	0	0	5	0	1	6
OG0005954	0	0	0	0	5	0	1	6
OG0005955	0	0	0	0	2	0	4	6
OG0005956	0	0	0	0	6	0	0	6
OG0005957	0	0	0	0	2	0	4	6
OG0005958	0	0	0	0	1	0	5	6
OG0005959	0	0	0	0	1	0	5	6
OG0005960	0	0	0	0	2	0	4	6
OG0005961	0	0	0	0	5	0	1	6
OG0005962	0	0	0	0	5	0	1	6
OG0005963	0	0	0	0	3	2	1	6
OG0005964	0	0	0	0	2	1	3	6
OG0005965	0	0	0	0	2	2	2	6
OG0005966	0	0	0	0	6	0	0	6
OG0005967	0	0	0	0	5	0	1	6
OG0005968	0	0	0	0	6	0	0	6
OG0005969	0	0	0	0	3	0	3	6
OG0005970	0	0	0	0	2	0	4	6
OG0005971	0	0	0	0	5	0	1	6
OG0005972	0	0	0	0	1	0	5	6
OG0005973	0	0	0	0	4	0	2	6
OG0005974	0	0	0	0	1	0	5	6
OG0005975	0	0	0	0	3	0	3	6
OG0005976	0	0	0	0	3	0	3	6
OG0005977	0	0	0	0	3	0	3	6
OG0005978	0	0	0	0	2	0	4	6
OG0005979	0	0	0	0	5	0	1	6
OG0005980	0	0	0	0	1	0	5	6
OG0005981	0	0	0	0	2	2	2	6
OG0005982	0	0	0	0	2	1	3	6
OG0005983	0	0	0	0	1	0	5	6
OG0005984	0	0	0	0	3	1	2	6
OG0005985	0	0	0	0	5	0	1	6
OG0005986	0	0	0	0	1	0	5	6
OG0005987	0	0	0	0	1	2	3	6
OG0005988	0	0	0	0	2	1	3	6
OG0005989	0	0	0	0	6	0	0	6
OG0005990	0	0	0	0	2	0	4	6
OG0005991	0	0	0	0	1	0	5	6
OG0005992	0	0	0	0	2	0	4	6
OG0005993	0	0	0	0	1	1	4	6
OG0005994	0	0	0	0	4	0	2	6
OG0005995	0	0	0	0	1	0	5	6
OG0005996	0	0	0	0	1	1	4	6
OG0005997	0	0	0	0	2	0	4	6
OG0005998	0	0	0	0	1	0	5	6
OG0005999	0	0	0	0	1	3	2	6
OG0006000	0	0	0	0	3	0	3	6
OG0006001	0	0	0	0	1	0	5	6
OG0006002	0	0	0	0	2	0	4	6
OG0006003	0	0	0	0	1	0	5	6
OG0006004	0	0	0	0	1	1	4	6
OG0006005	0	0	0	0	2	3	1	6
OG0006006	0	0	0	0	1	1	4	6
OG0006007	0	0	0	0	2	0	4	6
OG0006008	0	0	0	0	1	0	5	6
OG0006009	0	0	0	0	1	2	3	6
OG0006010	0	0	0	0	1	0	5	6
OG0006011	0	0	0	0	2	0	4	6
OG0006012	0	0	0	0	1	0	5	6
OG0006013	0	0	0	0	1	0	5	6
OG0006014	0	0	0	0	1	0	5	6
OG0006015	0	0	0	0	3	0	3	6
OG0006016	0	0	0	0	0	6	0	6
OG0006017	0	0	0	0	0	6	0	6
OG0006018	0	0	0	0	0	6	0	6
OG0006019	0	0	0	0	0	6	0	6
OG0006020	0	0	0	0	0	6	0	6
OG0006021	0	0	0	0	0	6	0	6
OG0006022	0	0	0	0	0	6	0	6
OG0006023	0	0	0	0	0	6	0	6
OG0006024	0	0	0	0	0	6	0	6
OG0006025	0	0	0	0	0	6	0	6
OG0006026	0	0	0	0	0	6	0	6
OG0006027	0	0	0	0	0	2	4	6
OG0006028	0	0	0	0	0	6	0	6
OG0006029	0	0	0	0	0	6	0	6
OG0006030	0	0	0	0	0	6	0	6
OG0006031	0	0	0	0	0	6	0	6
OG0006032	0	0	0	0	0	6	0	6
OG0006033	0	0	0	0	0	6	0	6
OG0006034	0	0	0	0	0	5	1	6
OG0006035	0	0	0	0	0	6	0	6
OG0006036	0	0	0	0	0	1	5	6
OG0006037	0	0	0	0	0	0	6	6
OG0006038	0	0	0	0	0	0	6	6
OG0006039	0	0	0	0	0	0	6	6
OG0006040	0	0	0	0	0	0	6	6
OG0006041	0	0	0	0	0	0	6	6
OG0006042	0	0	0	0	0	0	6	6
OG0006043	0	0	0	0	0	0	6	6
OG0006044	0	0	0	0	0	0	6	6
OG0006045	0	0	0	0	0	0	6	6
OG0006046	0	0	0	0	0	0	6	6
OG0006047	0	0	0	0	0	0	6	6
OG0006048	0	0	0	0	0	0	6	6
OG0006049	0	0	0	0	0	0	6	6
OG0006050	0	0	0	0	0	0	6	6
OG0006051	0	0	0	0	0	0	6	6
OG0006052	0	0	0	0	0	0	6	6
OG0006053	0	0	0	0	0	0	6	6
OG0006054	0	0	0	0	0	0	6	6
OG0006055	0	0	0	0	0	0	6	6
OG0006056	0	0	0	0	0	0	6	6
OG0006057	0	0	0	0	0	0	6	6
OG0006058	0	0	0	0	0	0	6	6
OG0006059	0	0	0	0	0	0	6	6
OG0006060	0	0	0	0	0	0	6	6
OG0006061	0	0	0	0	0	0	6	6
OG0006062	0	0	0	0	0	0	6	6
OG0006063	0	0	0	0	0	0	6	6
OG0006064	0	0	0	0	0	0	6	6
OG0006065	0	0	0	0	0	0	6	6
OG0006066	0	0	0	0	0	0	6	6
OG0006067	0	0	0	0	0	0	6	6
OG0006068	0	0	0	0	0	0	6	6
OG0006069	0	0	0	0	0	0	6	6
OG0006070	0	0	0	0	0	0	6	6
OG0006071	0	0	0	0	0	0	6	6
OG0006072	0	0	0	0	0	0	6	6
OG0006073	0	0	0	0	0	0	6	6
OG0006074	0	0	0	0	0	0	6	6
OG0006075	0	0	0	0	0	0	6	6
OG0006076	0	0	0	0	0	0	6	6
OG0006077	0	0	0	0	0	0	6	6
OG0006078	0	0	0	0	0	0	6	6
OG0006079	0	0	0	0	0	0	6	6
OG0006080	0	0	0	0	0	0	6	6
OG0006081	0	0	0	0	0	0	6	6
OG0006082	0	0	0	0	0	0	6	6
OG0006083	0	0	0	0	0	0	6	6
OG0006084	0	0	0	0	0	0	6	6
OG0006085	0	0	0	0	0	0	6	6
OG0006086	0	0	0	0	0	0	6	6
OG0006087	0	0	0	0	0	0	6	6
OG0006088	0	0	0	0	0	0	6	6
OG0006089	0	0	0	0	0	0	6	6
OG0006090	0	0	0	0	0	0	6	6
OG0006091	0	0	0	0	0	0	6	6
OG0006092	0	0	0	0	0	0	6	6
OG0006093	0	0	0	0	0	0	6	6
OG0006094	0	0	0	0	0	0	6	6
OG0006095	0	0	0	0	0	0	6	6
OG0006096	0	0	0	0	0	0	6	6
OG0006097	0	0	0	0	0	0	6	6
OG0006098	0	0	0	0	0	0	6	6
OG0006099	0	0	0	0	0	0	6	6
OG0006100	0	0	0	0	0	0	6	6
OG0006101	0	0	0	0	0	0	6	6
OG0006102	0	0	0	0	0	0	6	6
OG0006103	0	0	0	0	0	0	6	6
OG0006104	0	0	0	0	0	0	6	6
OG0006105	0	0	0	0	0	0	6	6
OG0006106	0	0	0	0	0	0	6	6
OG0006107	0	0	0	0	0	0	6	6
OG0006108	0	0	0	0	0	0	6	6
OG0006109	0	0	0	0	0	0	6	6
OG0006110	0	0	0	0	0	0	6	6
OG0006111	3	0	1	1	0	0	0	5
OG0006112	5	0	0	0	0	0	0	5
OG0006113	2	0	2	1	0	0	0	5
OG0006114	2	1	1	1	0	0	0	5
OG0006115	2	0	1	2	0	0	0	5
OG0006116	2	1	1	1	0	0	0	5
OG0006117	2	1	1	1	0	0	0	5
OG0006118	2	1	1	0	0	1	0	5
OG0006119	2	1	1	1	0	0	0	5
OG0006120	2	1	1	0	0	1	0	5
OG0006121	2	1	1	1	0	0	0	5
OG0006122	2	1	1	1	0	0	0	5
OG0006123	5	0	0	0	0	0	0	5
OG0006124	2	1	1	1	0	0	0	5
OG0006125	2	1	1	1	0	0	0	5
OG0006126	2	1	0	1	0	1	0	5
OG0006127	2	1	1	1	0	0	0	5
OG0006128	4	0	0	1	0	0	0	5
OG0006129	2	1	1	1	0	0	0	5
OG0006130	2	1	1	1	0	0	0	5
OG0006131	2	1	1	1	0	0	0	5
OG0006132	2	1	1	1	0	0	0	5
OG0006133	2	1	1	1	0	0	0	5
OG0006134	5	0	0	0	0	0	0	5
OG0006135	2	1	0	1	0	1	0	5
OG0006136	2	1	1	0	0	1	0	5
OG0006137	2	1	1	1	0	0	0	5
OG0006138	3	1	1	0	0	0	0	5
OG0006139	2	1	1	1	0	0	0	5
OG0006140	2	1	0	0	0	2	0	5
OG0006141	2	1	1	1	0	0	0	5
OG0006142	2	1	1	1	0	0	0	5
OG0006143	2	1	1	0	0	1	0	5
OG0006144	2	1	1	0	0	1	0	5
OG0006145	2	1	1	1	0	0	0	5
OG0006146	2	1	1	1	0	0	0	5
OG0006147	2	1	1	1	0	0	0	5
OG0006148	3	1	1	0	0	0	0	5
OG0006149	2	1	1	1	0	0	0	5
OG0006150	2	1	1	1	0	0	0	5
OG0006151	2	1	1	1	0	0	0	5
OG0006152	1	1	1	1	0	1	0	5
OG0006153	2	1	0	1	0	1	0	5
OG0006154	2	1	1	1	0	0	0	5
OG0006155	2	1	1	1	0	0	0	5
OG0006156	3	0	1	1	0	0	0	5
OG0006157	1	0	0	3	0	1	0	5
OG0006158	2	1	1	1	0	0	0	5
OG0006159	5	0	0	0	0	0	0	5
OG0006160	2	1	1	1	0	0	0	5
OG0006161	2	1	1	1	0	0	0	5
OG0006162	2	1	1	1	0	0	0	5
OG0006163	2	1	1	1	0	0	0	5
OG0006164	2	1	1	0	0	1	0	5
OG0006165	2	0	0	0	0	2	1	5
OG0006166	2	1	1	1	0	0	0	5
OG0006167	5	0	0	0	0	0	0	5
OG0006168	2	1	1	1	0	0	0	5
OG0006169	2	1	1	1	0	0	0	5
OG0006170	2	1	1	1	0	0	0	5
OG0006171	2	1	1	1	0	0	0	5
OG0006172	3	0	1	0	0	1	0	5
OG0006173	2	1	1	1	0	0	0	5
OG0006174	2	1	0	1	0	1	0	5
OG0006175	2	1	1	1	0	0	0	5
OG0006176	5	0	0	0	0	0	0	5
OG0006177	2	0	1	2	0	0	0	5
OG0006178	2	1	1	1	0	0	0	5
OG0006179	2	1	1	1	0	0	0	5
OG0006180	2	1	1	1	0	0	0	5
OG0006181	5	0	0	0	0	0	0	5
OG0006182	2	0	1	2	0	0	0	5
OG0006183	1	1	1	1	0	1	0	5
OG0006184	1	1	1	1	0	1	0	5
OG0006185	1	1	1	1	0	1	0	5
OG0006186	2	1	1	1	0	0	0	5
OG0006187	2	1	1	1	0	0	0	5
OG0006188	2	1	1	1	0	0	0	5
OG0006189	3	0	1	0	0	1	0	5
OG0006190	2	1	1	0	0	1	0	5
OG0006191	2	1	1	1	0	0	0	5
OG0006192	2	0	1	1	0	1	0	5
OG0006193	2	1	1	1	0	0	0	5
OG0006194	4	0	1	0	0	0	0	5
OG0006195	2	0	1	1	0	1	0	5
OG0006196	2	1	1	1	0	0	0	5
OG0006197	2	1	1	1	0	0	0	5
OG0006198	2	0	1	0	0	2	0	5
OG0006199	2	0	0	0	0	1	2	5
OG0006200	2	1	1	1	0	0	0	5
OG0006201	1	1	1	2	0	0	0	5
OG0006202	1	1	1	1	0	1	0	5
OG0006203	2	1	1	1	0	0	0	5
OG0006204	2	1	1	1	0	0	0	5
OG0006205	2	1	1	1	0	0	0	5
OG0006206	2	1	1	1	0	0	0	5
OG0006207	2	1	1	1	0	0	0	5
OG0006208	3	0	1	1	0	0	0	5
OG0006209	1	1	1	1	0	1	0	5
OG0006210	3	1	0	1	0	0	0	5
OG0006211	2	1	1	1	0	0	0	5
OG0006212	2	1	1	1	0	0	0	5
OG0006213	2	1	1	1	0	0	0	5
OG0006214	2	1	1	1	0	0	0	5
OG0006215	2	1	1	1	0	0	0	5
OG0006216	2	1	1	1	0	0	0	5
OG0006217	2	1	1	1	0	0	0	5
OG0006218	2	1	1	1	0	0	0	5
OG0006219	2	1	1	1	0	0	0	5
OG0006220	1	1	1	1	0	1	0	5
OG0006221	2	1	1	1	0	0	0	5
OG0006222	2	1	1	1	0	0	0	5
OG0006223	2	1	1	1	0	0	0	5
OG0006224	2	1	1	1	0	0	0	5
OG0006225	2	1	1	1	0	0	0	5
OG0006226	1	1	1	2	0	0	0	5
OG0006227	2	1	1	1	0	0	0	5
OG0006228	2	1	1	1	0	0	0	5
OG0006229	2	1	1	1	0	0	0	5
OG0006230	4	0	1	0	0	0	0	5
OG0006231	2	1	0	1	0	1	0	5
OG0006232	2	1	1	1	0	0	0	5
OG0006233	4	1	0	0	0	0	0	5
OG0006234	2	1	1	1	0	0	0	5
OG0006235	3	1	1	0	0	0	0	5
OG0006236	2	1	1	1	0	0	0	5
OG0006237	2	1	1	1	0	0	0	5
OG0006238	2	1	1	1	0	0	0	5
OG0006239	2	1	1	1	0	0	0	5
OG0006240	2	1	1	0	0	1	0	5
OG0006241	2	0	1	1	0	1	0	5
OG0006242	2	1	1	1	0	0	0	5
OG0006243	2	1	1	1	0	0	0	5
OG0006244	2	1	1	0	0	1	0	5
OG0006245	2	1	0	1	0	1	0	5
OG0006246	2	1	1	0	0	1	0	5
OG0006247	2	1	1	1	0	0	0	5
OG0006248	2	1	1	0	0	1	0	5
OG0006249	2	1	1	1	0	0	0	5
OG0006250	2	1	1	1	0	0	0	5
OG0006251	2	1	0	1	0	1	0	5
OG0006252	2	1	1	0	0	1	0	5
OG0006253	2	1	1	1	0	0	0	5
OG0006254	2	1	1	1	0	0	0	5
OG0006255	2	1	1	1	0	0	0	5
OG0006256	3	1	0	0	0	1	0	5
OG0006257	2	1	1	1	0	0	0	5
OG0006258	2	1	0	1	0	1	0	5
OG0006259	1	1	1	1	0	1	0	5
OG0006260	1	0	1	1	0	1	1	5
OG0006261	2	1	1	1	0	0	0	5
OG0006262	5	0	0	0	0	0	0	5
OG0006263	2	1	0	1	0	1	0	5
OG0006264	3	0	1	1	0	0	0	5
OG0006265	2	1	1	1	0	0	0	5
OG0006266	2	0	0	0	0	1	2	5
OG0006267	2	1	1	1	0	0	0	5
OG0006268	2	1	1	1	0	0	0	5
OG0006269	2	1	1	1	0	0	0	5
OG0006270	2	1	1	1	0	0	0	5
OG0006271	2	1	1	0	0	1	0	5
OG0006272	2	1	1	1	0	0	0	5
OG0006273	3	1	0	1	0	0	0	5
OG0006274	2	1	1	1	0	0	0	5
OG0006275	2	0	1	1	0	1	0	5
OG0006276	2	0	1	1	0	1	0	5
OG0006277	2	1	1	1	0	0	0	5
OG0006278	2	0	1	1	0	1	0	5
OG0006279	5	0	0	0	0	0	0	5
OG0006280	1	0	0	0	1	1	2	5
OG0006281	2	1	1	1	0	0	0	5
OG0006282	2	1	1	1	0	0	0	5
OG0006283	5	0	0	0	0	0	0	5
OG0006284	2	0	1	1	0	1	0	5
OG0006285	3	0	1	1	0	0	0	5
OG0006286	1	1	1	1	0	1	0	5
OG0006287	2	1	1	1	0	0	0	5
OG0006288	2	1	1	1	0	0	0	5
OG0006289	2	1	1	1	0	0	0	5
OG0006290	2	1	1	1	0	0	0	5
OG0006291	2	1	1	1	0	0	0	5
OG0006292	2	1	1	1	0	0	0	5
OG0006293	4	0	1	0	0	0	0	5
OG0006294	2	1	1	1	0	0	0	5
OG0006295	2	1	1	1	0	0	0	5
OG0006296	2	0	1	1	0	1	0	5
OG0006297	2	0	1	1	0	1	0	5
OG0006298	2	1	1	1	0	0	0	5
OG0006299	1	0	1	1	0	1	1	5
OG0006300	3	1	0	0	0	1	0	5
OG0006301	2	1	1	1	0	0	0	5
OG0006302	3	1	1	0	0	0	0	5
OG0006303	2	1	1	1	0	0	0	5
OG0006304	2	1	1	1	0	0	0	5
OG0006305	2	1	1	1	0	0	0	5
OG0006306	2	1	1	1	0	0	0	5
OG0006307	2	1	1	0	0	1	0	5
OG0006308	3	1	0	1	0	0	0	5
OG0006309	2	1	1	1	0	0	0	5
OG0006310	1	1	0	0	1	1	1	5
OG0006311	2	1	1	1	0	0	0	5
OG0006312	2	1	1	1	0	0	0	5
OG0006313	3	0	0	0	0	0	2	5
OG0006314	3	0	1	1	0	0	0	5
OG0006315	1	1	1	1	0	1	0	5
OG0006316	1	1	0	1	0	1	1	5
OG0006317	5	0	0	0	0	0	0	5
OG0006318	2	1	1	1	0	0	0	5
OG0006319	5	0	0	0	0	0	0	5
OG0006320	2	1	1	1	0	0	0	5
OG0006321	2	1	1	1	0	0	0	5
OG0006322	5	0	0	0	0	0	0	5
OG0006323	1	1	0	1	1	0	1	5
OG0006324	5	0	0	0	0	0	0	5
OG0006325	2	1	1	1	0	0	0	5
OG0006326	2	1	1	1	0	0	0	5
OG0006327	3	1	1	0	0	0	0	5
OG0006328	1	1	1	1	0	1	0	5
OG0006329	2	1	1	1	0	0	0	5
OG0006330	4	0	1	0	0	0	0	5
OG0006331	1	1	1	1	0	1	0	5
OG0006332	2	1	1	1	0	0	0	5
OG0006333	2	1	1	1	0	0	0	5
OG0006334	5	0	0	0	0	0	0	5
OG0006335	2	1	1	1	0	0	0	5
OG0006336	2	1	1	1	0	0	0	5
OG0006337	2	1	1	1	0	0	0	5
OG0006338	1	1	0	1	1	0	1	5
OG0006339	2	1	1	1	0	0	0	5
OG0006340	2	1	1	1	0	0	0	5
OG0006341	3	0	1	0	0	1	0	5
OG0006342	2	1	1	1	0	0	0	5
OG0006343	2	1	1	1	0	0	0	5
OG0006344	1	1	0	0	0	2	1	5
OG0006345	2	1	1	1	0	0	0	5
OG0006346	2	1	1	1	0	0	0	5
OG0006347	2	0	0	0	1	1	1	5
OG0006348	2	1	1	1	0	0	0	5
OG0006349	4	1	0	0	0	0	0	5
OG0006350	2	1	0	0	0	1	1	5
OG0006351	2	1	1	1	0	0	0	5
OG0006352	2	0	0	0	1	1	1	5
OG0006353	1	1	1	1	0	1	0	5
OG0006354	2	1	1	0	0	0	1	5
OG0006355	1	1	1	1	0	1	0	5
OG0006356	2	1	1	0	0	1	0	5
OG0006357	1	1	1	1	0	1	0	5
OG0006358	2	0	0	0	1	1	1	5
OG0006359	2	1	1	1	0	0	0	5
OG0006360	5	0	0	0	0	0	0	5
OG0006361	3	1	0	1	0	0	0	5
OG0006362	2	1	0	1	0	1	0	5
OG0006363	3	0	1	1	0	0	0	5
OG0006364	2	1	1	1	0	0	0	5
OG0006365	2	1	1	1	0	0	0	5
OG0006366	2	0	0	0	1	1	1	5
OG0006367	2	1	1	1	0	0	0	5
OG0006368	2	1	1	1	0	0	0	5
OG0006369	2	1	1	1	0	0	0	5
OG0006370	2	0	1	1	0	1	0	5
OG0006371	2	1	1	1	0	0	0	5
OG0006372	2	1	1	1	0	0	0	5
OG0006373	1	1	1	1	0	1	0	5
OG0006374	2	0	1	1	0	1	0	5
OG0006375	2	1	1	1	0	0	0	5
OG0006376	2	1	1	1	0	0	0	5
OG0006377	2	1	1	1	0	0	0	5
OG0006378	2	1	1	1	0	0	0	5
OG0006379	2	1	1	1	0	0	0	5
OG0006380	2	1	1	1	0	0	0	5
OG0006381	2	1	1	1	0	0	0	5
OG0006382	1	1	1	1	0	1	0	5
OG0006383	2	1	1	1	0	0	0	5
OG0006384	3	1	0	1	0	0	0	5
OG0006385	2	1	1	1	0	0	0	5
OG0006386	2	1	1	1	0	0	0	5
OG0006387	2	1	1	0	0	1	0	5
OG0006388	2	0	1	1	0	1	0	5
OG0006389	2	1	1	1	0	0	0	5
OG0006390	3	0	1	1	0	0	0	5
OG0006391	2	1	1	0	0	1	0	5
OG0006392	2	1	1	1	0	0	0	5
OG0006393	2	0	1	1	0	1	0	5
OG0006394	4	1	0	0	0	0	0	5
OG0006395	2	1	1	1	0	0	0	5
OG0006396	2	0	1	1	0	1	0	5
OG0006397	4	0	0	0	0	1	0	5
OG0006398	2	1	1	1	0	0	0	5
OG0006399	2	1	1	1	0	0	0	5
OG0006400	2	0	0	0	1	1	1	5
OG0006401	2	1	0	1	0	1	0	5
OG0006402	3	1	1	0	0	0	0	5
OG0006403	2	1	1	1	0	0	0	5
OG0006404	4	0	1	0	0	0	0	5
OG0006405	2	1	0	1	0	1	0	5
OG0006406	2	1	1	1	0	0	0	5
OG0006407	2	1	1	1	0	0	0	5
OG0006408	2	1	1	0	0	1	0	5
OG0006409	2	0	0	0	2	0	1	5
OG0006410	2	0	0	0	1	1	1	5
OG0006411	2	1	1	1	0	0	0	5
OG0006412	2	0	1	1	0	1	0	5
OG0006413	2	1	1	1	0	0	0	5
OG0006414	3	0	1	1	0	0	0	5
OG0006415	2	1	1	1	0	0	0	5
OG0006416	2	1	1	0	0	1	0	5
OG0006417	1	0	1	1	1	0	1	5
OG0006418	2	1	1	1	0	0	0	5
OG0006419	2	1	1	1	0	0	0	5
OG0006420	2	1	1	1	0	0	0	5
OG0006421	2	1	1	1	0	0	0	5
OG0006422	2	1	1	1	0	0	0	5
OG0006423	2	1	1	0	0	1	0	5
OG0006424	2	1	1	1	0	0	0	5
OG0006425	2	1	1	1	0	0	0	5
OG0006426	2	1	1	1	0	0	0	5
OG0006427	2	1	1	1	0	0	0	5
OG0006428	2	1	1	1	0	0	0	5
OG0006429	2	1	1	1	0	0	0	5
OG0006430	2	0	0	0	1	1	1	5
OG0006431	2	1	1	1	0	0	0	5
OG0006432	2	1	1	1	0	0	0	5
OG0006433	1	1	1	1	0	1	0	5
OG0006434	2	1	1	1	0	0	0	5
OG0006435	2	1	1	1	0	0	0	5
OG0006436	1	1	1	1	0	1	0	5
OG0006437	2	1	1	1	0	0	0	5
OG0006438	2	1	1	1	0	0	0	5
OG0006439	2	1	1	1	0	0	0	5
OG0006440	2	0	1	0	0	2	0	5
OG0006441	2	1	1	1	0	0	0	5
OG0006442	2	1	1	1	0	0	0	5
OG0006443	2	1	1	1	0	0	0	5
OG0006444	2	1	1	1	0	0	0	5
OG0006445	2	1	0	1	0	1	0	5
OG0006446	2	1	1	1	0	0	0	5
OG0006447	2	1	1	0	0	1	0	5
OG0006448	2	1	1	1	0	0	0	5
OG0006449	2	1	1	1	0	0	0	5
OG0006450	2	1	1	1	0	0	0	5
OG0006451	2	0	1	1	0	1	0	5
OG0006452	2	0	2	1	0	0	0	5
OG0006453	2	0	2	1	0	0	0	5
OG0006454	2	1	1	1	0	0	0	5
OG0006455	2	0	1	1	0	1	0	5
OG0006456	2	1	1	1	0	0	0	5
OG0006457	2	0	1	2	0	0	0	5
OG0006458	2	1	1	1	0	0	0	5
OG0006459	2	0	1	1	0	1	0	5
OG0006460	3	0	1	1	0	0	0	5
OG0006461	5	0	0	0	0	0	0	5
OG0006462	2	1	1	1	0	0	0	5
OG0006463	2	1	1	1	0	0	0	5
OG0006464	3	1	1	0	0	0	0	5
OG0006465	2	1	1	1	0	0	0	5
OG0006466	2	1	1	1	0	0	0	5
OG0006467	3	1	0	1	0	0	0	5
OG0006468	2	1	1	1	0	0	0	5
OG0006469	2	1	1	1	0	0	0	5
OG0006470	2	1	1	1	0	0	0	5
OG0006471	2	1	1	1	0	0	0	5
OG0006472	2	1	1	1	0	0	0	5
OG0006473	2	1	1	1	0	0	0	5
OG0006474	2	0	1	1	0	1	0	5
OG0006475	2	0	1	1	0	1	0	5
OG0006476	2	1	1	1	0	0	0	5
OG0006477	2	1	1	1	0	0	0	5
OG0006478	5	0	0	0	0	0	0	5
OG0006479	1	0	0	3	0	0	1	5
OG0006480	2	0	1	1	0	1	0	5
OG0006481	2	1	1	1	0	0	0	5
OG0006482	2	0	1	1	0	1	0	5
OG0006483	2	0	2	1	0	0	0	5
OG0006484	1	1	1	1	0	1	0	5
OG0006485	2	1	1	1	0	0	0	5
OG0006486	1	1	1	2	0	0	0	5
OG0006487	2	1	1	1	0	0	0	5
OG0006488	2	0	0	0	1	1	1	5
OG0006489	2	1	1	1	0	0	0	5
OG0006490	2	1	1	1	0	0	0	5
OG0006491	2	1	1	1	0	0	0	5
OG0006492	2	0	1	0	0	1	1	5
OG0006493	3	0	1	1	0	0	0	5
OG0006494	3	1	1	0	0	0	0	5
OG0006495	2	1	1	0	0	1	0	5
OG0006496	2	1	1	1	0	0	0	5
OG0006497	1	1	1	1	0	1	0	5
OG0006498	2	1	1	0	0	1	0	5
OG0006499	2	1	1	1	0	0	0	5
OG0006500	2	1	1	0	0	1	0	5
OG0006501	2	1	1	1	0	0	0	5
OG0006502	3	1	1	0	0	0	0	5
OG0006503	2	1	1	1	0	0	0	5
OG0006504	3	0	1	1	0	0	0	5
OG0006505	2	1	1	1	0	0	0	5
OG0006506	2	1	1	1	0	0	0	5
OG0006507	2	0	1	1	0	0	1	5
OG0006508	2	1	1	1	0	0	0	5
OG0006509	3	0	1	1	0	0	0	5
OG0006510	2	1	1	1	0	0	0	5
OG0006511	2	0	1	1	0	0	1	5
OG0006512	2	1	1	1	0	0	0	5
OG0006513	5	0	0	0	0	0	0	5
OG0006514	2	0	0	1	1	0	1	5
OG0006515	2	1	1	1	0	0	0	5
OG0006516	1	1	1	1	0	1	0	5
OG0006517	2	0	0	1	0	2	0	5
OG0006518	3	2	0	0	0	0	0	5
OG0006519	2	1	1	1	0	0	0	5
OG0006520	2	1	1	1	0	0	0	5
OG0006521	2	1	1	1	0	0	0	5
OG0006522	2	1	1	1	0	0	0	5
OG0006523	2	0	1	1	0	1	0	5
OG0006524	2	1	1	0	0	1	0	5
OG0006525	2	1	1	0	0	1	0	5
OG0006526	2	1	1	0	0	1	0	5
OG0006527	1	1	1	1	0	1	0	5
OG0006528	2	1	1	1	0	0	0	5
OG0006529	2	1	1	1	0	0	0	5
OG0006530	2	1	1	1	0	0	0	5
OG0006531	2	1	1	1	0	0	0	5
OG0006532	2	1	1	1	0	0	0	5
OG0006533	2	1	1	1	0	0	0	5
OG0006534	5	0	0	0	0	0	0	5
OG0006535	2	1	1	1	0	0	0	5
OG0006536	2	1	1	1	0	0	0	5
OG0006537	2	1	1	0	0	1	0	5
OG0006538	2	0	1	1	0	1	0	5
OG0006539	5	0	0	0	0	0	0	5
OG0006540	2	1	1	1	0	0	0	5
OG0006541	5	0	0	0	0	0	0	5
OG0006542	2	1	1	1	0	0	0	5
OG0006543	2	1	0	1	0	0	1	5
OG0006544	2	1	1	1	0	0	0	5
OG0006545	2	1	1	0	0	1	0	5
OG0006546	2	1	1	1	0	0	0	5
OG0006547	2	1	1	1	0	0	0	5
OG0006548	1	1	1	1	0	1	0	5
OG0006549	1	1	1	1	0	1	0	5
OG0006550	1	1	1	1	0	1	0	5
OG0006551	3	0	0	0	0	2	0	5
OG0006552	5	0	0	0	0	0	0	5
OG0006553	2	1	1	1	0	0	0	5
OG0006554	2	1	0	1	0	1	0	5
OG0006555	2	0	2	0	0	1	0	5
OG0006556	2	1	1	1	0	0	0	5
OG0006557	2	1	1	1	0	0	0	5
OG0006558	2	1	1	1	0	0	0	5
OG0006559	2	1	1	1	0	0	0	5
OG0006560	2	1	1	1	0	0	0	5
OG0006561	2	0	0	0	1	1	1	5
OG0006562	2	1	1	1	0	0	0	5
OG0006563	2	1	1	1	0	0	0	5
OG0006564	2	0	1	1	0	1	0	5
OG0006565	3	0	1	1	0	0	0	5
OG0006566	2	1	1	1	0	0	0	5
OG0006567	2	1	1	1	0	0	0	5
OG0006568	2	1	1	1	0	0	0	5
OG0006569	2	1	1	1	0	0	0	5
OG0006570	5	0	0	0	0	0	0	5
OG0006571	1	1	1	2	0	0	0	5
OG0006572	2	1	1	1	0	0	0	5
OG0006573	2	1	1	1	0	0	0	5
OG0006574	2	1	1	1	0	0	0	5
OG0006575	1	1	1	1	0	1	0	5
OG0006576	2	1	0	1	0	1	0	5
OG0006577	2	1	1	1	0	0	0	5
OG0006578	2	1	1	1	0	0	0	5
OG0006579	1	1	1	1	0	1	0	5
OG0006580	1	1	1	1	0	1	0	5
OG0006581	2	0	1	1	0	1	0	5
OG0006582	3	1	1	0	0	0	0	5
OG0006583	2	0	0	0	1	1	1	5
OG0006584	2	1	0	2	0	0	0	5
OG0006585	2	1	2	0	0	0	0	5
OG0006586	5	0	0	0	0	0	0	5
OG0006587	2	1	1	1	0	0	0	5
OG0006588	2	1	1	1	0	0	0	5
OG0006589	3	0	1	1	0	0	0	5
OG0006590	2	1	1	1	0	0	0	5
OG0006591	2	1	1	1	0	0	0	5
OG0006592	5	0	0	0	0	0	0	5
OG0006593	2	1	1	0	0	1	0	5
OG0006594	3	1	1	0	0	0	0	5
OG0006595	3	0	1	1	0	0	0	5
OG0006596	2	1	1	1	0	0	0	5
OG0006597	2	1	1	1	0	0	0	5
OG0006598	2	1	1	1	0	0	0	5
OG0006599	2	1	1	1	0	0	0	5
OG0006600	2	1	1	1	0	0	0	5
OG0006601	3	0	0	0	1	1	0	5
OG0006602	1	1	1	1	0	1	0	5
OG0006603	2	0	1	1	0	1	0	5
OG0006604	3	0	1	1	0	0	0	5
OG0006605	2	1	1	1	0	0	0	5
OG0006606	4	0	1	0	0	0	0	5
OG0006607	3	0	1	0	0	1	0	5
OG0006608	2	1	1	0	0	1	0	5
OG0006609	3	0	1	1	0	0	0	5
OG0006610	2	1	1	1	0	0	0	5
OG0006611	2	1	1	1	0	0	0	5
OG0006612	1	1	1	1	0	1	0	5
OG0006613	1	1	1	1	0	1	0	5
OG0006614	1	1	1	1	0	1	0	5
OG0006615	1	1	1	1	0	1	0	5
OG0006616	5	0	0	0	0	0	0	5
OG0006617	1	0	0	4	0	0	0	5
OG0006618	1	1	1	1	0	1	0	5
OG0006619	1	1	1	1	0	1	0	5
OG0006620	2	0	1	1	0	1	0	5
OG0006621	2	1	1	1	0	0	0	5
OG0006622	2	1	1	1	0	0	0	5
OG0006623	2	1	1	1	0	0	0	5
OG0006624	2	1	1	1	0	0	0	5
OG0006625	5	0	0	0	0	0	0	5
OG0006626	2	1	1	1	0	0	0	5
OG0006627	2	1	1	1	0	0	0	5
OG0006628	5	0	0	0	0	0	0	5
OG0006629	2	1	1	1	0	0	0	5
OG0006630	2	1	1	1	0	0	0	5
OG0006631	3	0	1	1	0	0	0	5
OG0006632	2	1	1	1	0	0	0	5
OG0006633	2	1	1	1	0	0	0	5
OG0006634	2	1	0	1	0	1	0	5
OG0006635	2	1	1	1	0	0	0	5
OG0006636	2	1	1	0	0	1	0	5
OG0006637	2	1	1	1	0	0	0	5
OG0006638	4	0	1	0	0	0	0	5
OG0006639	3	1	1	0	0	0	0	5
OG0006640	2	2	1	0	0	0	0	5
OG0006641	2	1	1	1	0	0	0	5
OG0006642	2	1	1	1	0	0	0	5
OG0006643	1	1	1	1	1	0	0	5
OG0006644	1	1	1	1	0	1	0	5
OG0006645	1	1	1	1	0	1	0	5
OG0006646	3	0	1	0	0	1	0	5
OG0006647	5	0	0	0	0	0	0	5
OG0006648	2	1	1	1	0	0	0	5
OG0006649	2	1	1	1	0	0	0	5
OG0006650	2	1	1	1	0	0	0	5
OG0006651	2	1	1	1	0	0	0	5
OG0006652	2	1	1	0	0	1	0	5
OG0006653	2	1	1	1	0	0	0	5
OG0006654	2	0	1	1	0	1	0	5
OG0006655	2	1	1	1	0	0	0	5
OG0006656	1	2	1	1	0	0	0	5
OG0006657	2	1	1	0	0	1	0	5
OG0006658	2	1	1	1	0	0	0	5
OG0006659	2	1	1	1	0	0	0	5
OG0006660	5	0	0	0	0	0	0	5
OG0006661	2	0	1	1	0	1	0	5
OG0006662	1	1	1	1	0	1	0	5
OG0006663	2	0	1	1	0	1	0	5
OG0006664	2	1	1	1	0	0	0	5
OG0006665	2	1	1	1	0	0	0	5
OG0006666	2	1	0	1	0	1	0	5
OG0006667	4	0	0	0	0	1	0	5
OG0006668	2	1	1	1	0	0	0	5
OG0006669	2	0	1	1	0	0	1	5
OG0006670	2	1	1	1	0	0	0	5
OG0006671	2	1	1	1	0	0	0	5
OG0006672	2	0	1	1	0	1	0	5
OG0006673	2	1	1	1	0	0	0	5
OG0006674	1	1	1	1	0	1	0	5
OG0006675	1	1	0	1	0	1	1	5
OG0006676	2	0	1	1	0	1	0	5
OG0006677	4	0	0	1	0	0	0	5
OG0006678	2	1	1	0	0	1	0	5
OG0006679	3	0	1	0	0	1	0	5
OG0006680	2	1	1	1	0	0	0	5
OG0006681	2	0	1	1	0	1	0	5
OG0006682	1	1	1	1	0	1	0	5
OG0006683	2	1	1	1	0	0	0	5
OG0006684	2	1	0	1	0	1	0	5
OG0006685	5	0	0	0	0	0	0	5
OG0006686	2	1	0	1	0	1	0	5
OG0006687	2	1	1	0	0	0	1	5
OG0006688	2	1	1	1	0	0	0	5
OG0006689	2	1	1	1	0	0	0	5
OG0006690	1	1	1	1	0	1	0	5
OG0006691	1	1	1	2	0	0	0	5
OG0006692	1	1	1	1	0	1	0	5
OG0006693	2	1	1	1	0	0	0	5
OG0006694	2	1	1	1	0	0	0	5
OG0006695	1	2	0	2	0	0	0	5
OG0006696	1	1	1	2	0	0	0	5
OG0006697	1	1	1	2	0	0	0	5
OG0006698	1	1	1	2	0	0	0	5
OG0006699	1	1	0	1	0	2	0	5
OG0006700	1	1	1	1	0	1	0	5
OG0006701	1	1	0	0	1	1	1	5
OG0006702	0	5	0	0	0	0	0	5
OG0006703	0	5	0	0	0	0	0	5
OG0006704	0	5	0	0	0	0	0	5
OG0006705	0	1	0	0	1	1	2	5
OG0006706	0	5	0	0	0	0	0	5
OG0006707	0	5	0	0	0	0	0	5
OG0006708	0	2	2	1	0	0	0	5
OG0006709	0	2	1	2	0	0	0	5
OG0006710	0	5	0	0	0	0	0	5
OG0006711	0	5	0	0	0	0	0	5
OG0006712	0	2	2	1	0	0	0	5
OG0006713	0	5	0	0	0	0	0	5
OG0006714	0	5	0	0	0	0	0	5
OG0006715	0	1	2	0	1	0	1	5
OG0006716	0	1	0	1	0	0	3	5
OG0006717	0	1	1	0	0	2	1	5
OG0006718	0	1	0	0	0	2	2	5
OG0006719	0	1	0	1	1	0	2	5
OG0006720	0	1	3	1	0	0	0	5
OG0006721	0	1	0	0	0	0	4	5
OG0006722	0	1	1	0	1	1	1	5
OG0006723	0	3	2	0	0	0	0	5
OG0006724	0	5	0	0	0	0	0	5
OG0006725	0	1	4	0	0	0	0	5
OG0006726	0	1	1	1	0	1	1	5
OG0006727	0	5	0	0	0	0	0	5
OG0006728	0	5	0	0	0	0	0	5
OG0006729	0	5	0	0	0	0	0	5
OG0006730	0	1	1	1	0	2	0	5
OG0006731	0	1	1	3	0	0	0	5
OG0006732	0	5	0	0	0	0	0	5
OG0006733	0	5	0	0	0	0	0	5
OG0006734	0	1	3	1	0	0	0	5
OG0006735	0	1	0	1	1	1	1	5
OG0006736	0	5	0	0	0	0	0	5
OG0006737	0	1	2	1	0	1	0	5
OG0006738	0	1	1	1	0	1	1	5
OG0006739	0	1	1	0	1	1	1	5
OG0006740	0	1	1	1	1	0	1	5
OG0006741	0	5	0	0	0	0	0	5
OG0006742	0	5	0	0	0	0	0	5
OG0006743	0	5	0	0	0	0	0	5
OG0006744	0	5	0	0	0	0	0	5
OG0006745	0	1	4	0	0	0	0	5
OG0006746	0	1	1	0	1	1	1	5
OG0006747	0	1	4	0	0	0	0	5
OG0006748	0	1	0	0	2	0	2	5
OG0006749	0	1	1	1	0	2	0	5
OG0006750	0	0	5	0	0	0	0	5
OG0006751	0	0	5	0	0	0	0	5
OG0006752	0	0	5	0	0	0	0	5
OG0006753	0	0	5	0	0	0	0	5
OG0006754	0	0	5	0	0	0	0	5
OG0006755	0	0	1	0	3	1	0	5
OG0006756	0	0	1	1	2	0	1	5
OG0006757	0	0	5	0	0	0	0	5
OG0006758	0	0	1	4	0	0	0	5
OG0006759	0	0	5	0	0	0	0	5
OG0006760	0	0	5	0	0	0	0	5
OG0006761	0	0	1	0	2	1	1	5
OG0006762	0	0	1	0	2	1	1	5
OG0006763	0	0	5	0	0	0	0	5
OG0006764	0	0	4	1	0	0	0	5
OG0006765	0	0	4	1	0	0	0	5
OG0006766	0	0	5	0	0	0	0	5
OG0006767	0	0	5	0	0	0	0	5
OG0006768	0	0	5	0	0	0	0	5
OG0006769	0	0	3	2	0	0	0	5
OG0006770	0	0	1	1	1	1	1	5
OG0006771	0	0	1	0	2	1	1	5
OG0006772	0	0	3	2	0	0	0	5
OG0006773	0	0	5	0	0	0	0	5
OG0006774	0	0	5	0	0	0	0	5
OG0006775	0	0	5	0	0	0	0	5
OG0006776	0	0	5	0	0	0	0	5
OG0006777	0	0	1	0	1	0	3	5
OG0006778	0	0	5	0	0	0	0	5
OG0006779	0	0	5	0	0	0	0	5
OG0006780	0	0	5	0	0	0	0	5
OG0006781	0	0	5	0	0	0	0	5
OG0006782	0	0	5	0	0	0	0	5
OG0006783	0	0	5	0	0	0	0	5
OG0006784	0	0	1	0	2	1	1	5
OG0006785	0	0	1	0	2	0	2	5
OG0006786	0	0	5	0	0	0	0	5
OG0006787	0	0	1	0	1	1	2	5
OG0006788	0	0	1	3	0	1	0	5
OG0006789	0	0	5	0	0	0	0	5
OG0006790	0	0	1	4	0	0	0	5
OG0006791	0	0	0	5	0	0	0	5
OG0006792	0	0	0	5	0	0	0	5
OG0006793	0	0	0	1	1	1	2	5
OG0006794	0	0	0	5	0	0	0	5
OG0006795	0	0	0	5	0	0	0	5
OG0006796	0	0	0	4	0	0	1	5
OG0006797	0	0	0	5	0	0	0	5
OG0006798	0	0	0	5	0	0	0	5
OG0006799	0	0	0	5	0	0	0	5
OG0006800	0	0	0	5	0	0	0	5
OG0006801	0	0	0	5	0	0	0	5
OG0006802	0	0	0	5	0	0	0	5
OG0006803	0	0	0	5	0	0	0	5
OG0006804	0	0	0	1	1	1	2	5
OG0006805	0	0	0	5	0	0	0	5
OG0006806	0	0	0	5	0	0	0	5
OG0006807	0	0	0	5	0	0	0	5
OG0006808	0	0	0	5	0	0	0	5
OG0006809	0	0	0	5	0	0	0	5
OG0006810	0	0	0	5	0	0	0	5
OG0006811	0	0	0	5	0	0	0	5
OG0006812	0	0	0	5	0	0	0	5
OG0006813	0	0	0	5	0	0	0	5
OG0006814	0	0	0	1	1	2	1	5
OG0006815	0	0	0	5	0	0	0	5
OG0006816	0	0	0	5	0	0	0	5
OG0006817	0	0	0	5	0	0	0	5
OG0006818	0	0	0	1	1	2	1	5
OG0006819	0	0	0	5	0	0	0	5
OG0006820	0	0	0	5	0	0	0	5
OG0006821	0	0	0	1	0	0	4	5
OG0006822	0	0	0	5	0	0	0	5
OG0006823	0	0	0	5	0	0	0	5
OG0006824	0	0	0	5	0	0	0	5
OG0006825	0	0	0	5	0	0	0	5
OG0006826	0	0	0	1	0	0	4	5
OG0006827	0	0	0	1	2	0	2	5
OG0006828	0	0	0	0	1	0	4	5
OG0006829	0	0	0	0	1	0	4	5
OG0006830	0	0	0	0	1	0	4	5
OG0006831	0	0	0	0	2	0	3	5
OG0006832	0	0	0	0	5	0	0	5
OG0006833	0	0	0	0	5	0	0	5
OG0006834	0	0	0	0	2	1	2	5
OG0006835	0	0	0	0	3	0	2	5
OG0006836	0	0	0	0	3	1	1	5
OG0006837	0	0	0	0	4	0	1	5
OG0006838	0	0	0	0	5	0	0	5
OG0006839	0	0	0	0	4	0	1	5
OG0006840	0	0	0	0	4	0	1	5
OG0006841	0	0	0	0	3	0	2	5
OG0006842	0	0	0	0	2	0	3	5
OG0006843	0	0	0	0	5	0	0	5
OG0006844	0	0	0	0	2	0	3	5
OG0006845	0	0	0	0	1	0	4	5
OG0006846	0	0	0	0	1	0	4	5
OG0006847	0	0	0	0	3	0	2	5
OG0006848	0	0	0	0	3	1	1	5
OG0006849	0	0	0	0	2	0	3	5
OG0006850	0	0	0	0	3	0	2	5
OG0006851	0	0	0	0	4	0	1	5
OG0006852	0	0	0	0	2	1	2	5
OG0006853	0	0	0	0	3	0	2	5
OG0006854	0	0	0	0	5	0	0	5
OG0006855	0	0	0	0	1	2	2	5
OG0006856	0	0	0	0	2	0	3	5
OG0006857	0	0	0	0	2	0	3	5
OG0006858	0	0	0	0	4	0	1	5
OG0006859	0	0	0	0	2	0	3	5
OG0006860	0	0	0	0	1	1	3	5
OG0006861	0	0	0	0	1	1	3	5
OG0006862	0	0	0	0	4	0	1	5
OG0006863	0	0	0	0	1	0	4	5
OG0006864	0	0	0	0	1	3	1	5
OG0006865	0	0	0	0	1	0	4	5
OG0006866	0	0	0	0	2	0	3	5
OG0006867	0	0	0	0	1	1	3	5
OG0006868	0	0	0	0	5	0	0	5
OG0006869	0	0	0	0	2	0	3	5
OG0006870	0	0	0	0	3	0	2	5
OG0006871	0	0	0	0	3	0	2	5
OG0006872	0	0	0	0	1	1	3	5
OG0006873	0	0	0	0	3	1	1	5
OG0006874	0	0	0	0	2	0	3	5
OG0006875	0	0	0	0	1	0	4	5
OG0006876	0	0	0	0	5	0	0	5
OG0006877	0	0	0	0	2	0	3	5
OG0006878	0	0	0	0	4	0	1	5
OG0006879	0	0	0	0	2	1	2	5
OG0006880	0	0	0	0	2	2	1	5
OG0006881	0	0	0	0	2	0	3	5
OG0006882	0	0	0	0	3	0	2	5
OG0006883	0	0	0	0	3	0	2	5
OG0006884	0	0	0	0	3	0	2	5
OG0006885	0	0	0	0	2	2	1	5
OG0006886	0	0	0	0	2	0	3	5
OG0006887	0	0	0	0	1	1	3	5
OG0006888	0	0	0	0	1	0	4	5
OG0006889	0	0	0	0	3	0	2	5
OG0006890	0	0	0	0	1	0	4	5
OG0006891	0	0	0	0	2	0	3	5
OG0006892	0	0	0	0	4	0	1	5
OG0006893	0	0	0	0	2	0	3	5
OG0006894	0	0	0	0	5	0	0	5
OG0006895	0	0	0	0	3	0	2	5
OG0006896	0	0	0	0	1	1	3	5
OG0006897	0	0	0	0	2	0	3	5
OG0006898	0	0	0	0	1	0	4	5
OG0006899	0	0	0	0	2	0	3	5
OG0006900	0	0	0	0	3	0	2	5
OG0006901	0	0	0	0	2	1	2	5
OG0006902	0	0	0	0	2	1	2	5
OG0006903	0	0	0	0	1	1	3	5
OG0006904	0	0	0	0	3	0	2	5
OG0006905	0	0	0	0	1	2	2	5
OG0006906	0	0	0	0	4	0	1	5
OG0006907	0	0	0	0	1	1	3	5
OG0006908	0	0	0	0	2	0	3	5
OG0006909	0	0	0	0	2	0	3	5
OG0006910	0	0	0	0	1	1	3	5
OG0006911	0	0	0	0	2	0	3	5
OG0006912	0	0	0	0	1	0	4	5
OG0006913	0	0	0	0	2	2	1	5
OG0006914	0	0	0	0	2	2	1	5
OG0006915	0	0	0	0	1	0	4	5
OG0006916	0	0	0	0	4	0	1	5
OG0006917	0	0	0	0	1	0	4	5
OG0006918	0	0	0	0	2	0	3	5
OG0006919	0	0	0	0	2	0	3	5
OG0006920	0	0	0	0	2	0	3	5
OG0006921	0	0	0	0	1	1	3	5
OG0006922	0	0	0	0	1	0	4	5
OG0006923	0	0	0	0	5	0	0	5
OG0006924	0	0	0	0	4	0	1	5
OG0006925	0	0	0	0	1	0	4	5
OG0006926	0	0	0	0	1	2	2	5
OG0006927	0	0	0	0	1	1	3	5
OG0006928	0	0	0	0	1	0	4	5
OG0006929	0	0	0	0	2	0	3	5
OG0006930	0	0	0	0	3	0	2	5
OG0006931	0	0	0	0	4	0	1	5
OG0006932	0	0	0	0	4	0	1	5
OG0006933	0	0	0	0	1	0	4	5
OG0006934	0	0	0	0	2	1	2	5
OG0006935	0	0	0	0	1	1	3	5
OG0006936	0	0	0	0	1	0	4	5
OG0006937	0	0	0	0	1	0	4	5
OG0006938	0	0	0	0	1	0	4	5
OG0006939	0	0	0	0	2	0	3	5
OG0006940	0	0	0	0	1	0	4	5
OG0006941	0	0	0	0	3	1	1	5
OG0006942	0	0	0	0	2	1	2	5
OG0006943	0	0	0	0	2	1	2	5
OG0006944	0	0	0	0	1	0	4	5
OG0006945	0	0	0	0	2	0	3	5
OG0006946	0	0	0	0	4	0	1	5
OG0006947	0	0	0	0	2	0	3	5
OG0006948	0	0	0	0	1	1	3	5
OG0006949	0	0	0	0	1	1	3	5
OG0006950	0	0	0	0	1	3	1	5
OG0006951	0	0	0	0	1	0	4	5
OG0006952	0	0	0	0	1	1	3	5
OG0006953	0	0	0	0	1	1	3	5
OG0006954	0	0	0	0	1	0	4	5
OG0006955	0	0	0	0	1	0	4	5
OG0006956	0	0	0	0	1	2	2	5
OG0006957	0	0	0	0	1	0	4	5
OG0006958	0	0	0	0	1	0	4	5
OG0006959	0	0	0	0	1	0	4	5
OG0006960	0	0	0	0	1	0	4	5
OG0006961	0	0	0	0	1	0	4	5
OG0006962	0	0	0	0	1	1	3	5
OG0006963	0	0	0	0	1	0	4	5
OG0006964	0	0	0	0	1	1	3	5
OG0006965	0	0	0	0	1	1	3	5
OG0006966	0	0	0	0	1	0	4	5
OG0006967	0	0	0	0	1	0	4	5
OG0006968	0	0	0	0	1	0	4	5
OG0006969	0	0	0	0	5	0	0	5
OG0006970	0	0	0	0	1	1	3	5
OG0006971	0	0	0	0	1	0	4	5
OG0006972	0	0	0	0	1	1	3	5
OG0006973	0	0	0	0	1	0	4	5
OG0006974	0	0	0	0	1	0	4	5
OG0006975	0	0	0	0	1	1	3	5
OG0006976	0	0	0	0	1	2	2	5
OG0006977	0	0	0	0	1	1	3	5
OG0006978	0	0	0	0	1	0	4	5
OG0006979	0	0	0	0	1	1	3	5
OG0006980	0	0	0	0	1	2	2	5
OG0006981	0	0	0	0	1	1	3	5
OG0006982	0	0	0	0	4	0	1	5
OG0006983	0	0	0	0	1	1	3	5
OG0006984	0	0	0	0	1	1	3	5
OG0006985	0	0	0	0	2	1	2	5
OG0006986	0	0	0	0	2	0	3	5
OG0006987	0	0	0	0	1	0	4	5
OG0006988	0	0	0	0	1	0	4	5
OG0006989	0	0	0	0	1	0	4	5
OG0006990	0	0	0	0	1	1	3	5
OG0006991	0	0	0	0	1	0	4	5
OG0006992	0	0	0	0	1	2	2	5
OG0006993	0	0	0	0	0	1	4	5
OG0006994	0	0	0	0	0	5	0	5
OG0006995	0	0	0	0	0	5	0	5
OG0006996	0	0	0	0	0	5	0	5
OG0006997	0	0	0	0	0	5	0	5
OG0006998	0	0	0	0	0	5	0	5
OG0006999	0	0	0	0	0	5	0	5
OG0007000	0	0	0	0	0	5	0	5
OG0007001	0	0	0	0	0	5	0	5
OG0007002	0	0	0	0	0	5	0	5
OG0007003	0	0	0	0	0	5	0	5
OG0007004	0	0	0	0	0	5	0	5
OG0007005	0	0	0	0	0	5	0	5
OG0007006	0	0	0	0	0	5	0	5
OG0007007	0	0	0	0	0	5	0	5
OG0007008	0	0	0	0	0	5	0	5
OG0007009	0	0	0	0	0	5	0	5
OG0007010	0	0	0	0	0	5	0	5
OG0007011	0	0	0	0	0	5	0	5
OG0007012	0	0	0	0	0	1	4	5
OG0007013	0	0	0	0	0	5	0	5
OG0007014	0	0	0	0	0	5	0	5
OG0007015	0	0	0	0	0	5	0	5
OG0007016	0	0	0	0	0	5	0	5
OG0007017	0	0	0	0	0	5	0	5
OG0007018	0	0	0	0	0	1	4	5
OG0007019	0	0	0	0	0	1	4	5
OG0007020	0	0	0	0	0	1	4	5
OG0007021	0	0	0	0	0	0	5	5
OG0007022	0	0	0	0	0	0	5	5
OG0007023	0	0	0	0	0	0	5	5
OG0007024	0	0	0	0	0	0	5	5
OG0007025	0	0	0	0	0	0	5	5
OG0007026	0	0	0	0	0	0	5	5
OG0007027	0	0	0	0	0	0	5	5
OG0007028	0	0	0	0	0	0	5	5
OG0007029	0	0	0	0	0	0	5	5
OG0007030	0	0	0	0	0	0	5	5
OG0007031	0	0	0	0	0	0	5	5
OG0007032	0	0	0	0	0	0	5	5
OG0007033	0	0	0	0	0	0	5	5
OG0007034	0	0	0	0	0	0	5	5
OG0007035	0	0	0	0	0	0	5	5
OG0007036	0	0	0	0	0	0	5	5
OG0007037	0	0	0	0	0	0	5	5
OG0007038	0	0	0	0	0	0	5	5
OG0007039	0	0	0	0	0	0	5	5
OG0007040	0	0	0	0	0	0	5	5
OG0007041	0	0	0	0	0	0	5	5
OG0007042	0	0	0	0	0	0	5	5
OG0007043	0	0	0	0	0	0	5	5
OG0007044	0	0	0	0	0	0	5	5
OG0007045	0	0	0	0	0	0	5	5
OG0007046	0	0	0	0	0	0	5	5
OG0007047	0	0	0	0	0	0	5	5
OG0007048	0	0	0	0	0	0	5	5
OG0007049	0	0	0	0	0	0	5	5
OG0007050	0	0	0	0	0	0	5	5
OG0007051	0	0	0	0	0	0	5	5
OG0007052	0	0	0	0	0	0	5	5
OG0007053	0	0	0	0	0	0	5	5
OG0007054	0	0	0	0	0	0	5	5
OG0007055	0	0	0	0	0	0	5	5
OG0007056	0	0	0	0	0	0	5	5
OG0007057	0	0	0	0	0	0	5	5
OG0007058	0	0	0	0	0	0	5	5
OG0007059	0	0	0	0	0	0	5	5
OG0007060	0	0	0	0	0	0	5	5
OG0007061	0	0	0	0	0	0	5	5
OG0007062	0	0	0	0	0	0	5	5
OG0007063	0	0	0	0	0	0	5	5
OG0007064	0	0	0	0	0	0	5	5
OG0007065	0	0	0	0	0	0	5	5
OG0007066	0	0	0	0	0	0	5	5
OG0007067	0	0	0	0	0	0	5	5
OG0007068	0	0	0	0	0	0	5	5
OG0007069	0	0	0	0	0	0	5	5
OG0007070	0	0	0	0	0	0	5	5
OG0007071	0	0	0	0	0	0	5	5
OG0007072	0	0	0	0	0	0	5	5
OG0007073	0	0	0	0	0	0	5	5
OG0007074	0	0	0	0	0	0	5	5
OG0007075	0	0	0	0	0	0	5	5
OG0007076	0	0	0	0	0	0	5	5
OG0007077	0	0	0	0	0	0	5	5
OG0007078	0	0	0	0	0	0	5	5
OG0007079	0	0	0	0	0	0	5	5
OG0007080	0	0	0	0	0	0	5	5
OG0007081	0	0	0	0	0	0	5	5
OG0007082	0	0	0	0	0	0	5	5
OG0007083	0	0	0	0	0	0	5	5
OG0007084	0	0	0	0	0	0	5	5
OG0007085	0	0	0	0	0	0	5	5
OG0007086	0	0	0	0	0	0	5	5
OG0007087	0	0	0	0	0	0	5	5
OG0007088	0	0	0	0	0	0	5	5
OG0007089	0	0	0	0	0	0	5	5
OG0007090	0	0	0	0	0	0	5	5
OG0007091	0	0	0	0	0	0	5	5
OG0007092	0	0	0	0	0	0	5	5
OG0007093	0	0	0	0	0	0	5	5
OG0007094	0	0	0	0	0	0	5	5
OG0007095	0	0	0	0	0	0	5	5
OG0007096	0	0	0	0	0	0	5	5
OG0007097	0	0	0	0	0	0	5	5
OG0007098	0	0	0	0	0	0	5	5
OG0007099	0	0	0	0	0	0	5	5
OG0007100	0	0	0	0	0	0	5	5
OG0007101	0	0	0	0	0	0	5	5
OG0007102	0	0	0	0	0	0	5	5
OG0007103	0	0	0	0	0	0	5	5
OG0007104	0	0	0	0	0	0	5	5
OG0007105	0	0	0	0	0	0	5	5
OG0007106	0	0	0	0	0	0	5	5
OG0007107	0	0	0	0	0	0	5	5
OG0007108	0	0	0	0	0	0	5	5
OG0007109	0	0	0	0	0	0	5	5
OG0007110	0	0	0	0	0	0	5	5
OG0007111	0	0	0	0	0	0	5	5
OG0007112	3	0	1	0	0	0	0	4
OG0007113	2	1	1	0	0	0	0	4
OG0007114	2	0	0	0	0	2	0	4
OG0007115	4	0	0	0	0	0	0	4
OG0007116	4	0	0	0	0	0	0	4
OG0007117	2	1	1	0	0	0	0	4
OG0007118	2	0	1	1	0	0	0	4
OG0007119	2	1	1	0	0	0	0	4
OG0007120	4	0	0	0	0	0	0	4
OG0007121	4	0	0	0	0	0	0	4
OG0007122	2	0	1	1	0	0	0	4
OG0007123	2	0	1	1	0	0	0	4
OG0007124	3	0	1	0	0	0	0	4
OG0007125	2	0	0	0	1	0	1	4
OG0007126	1	1	1	1	0	0	0	4
OG0007127	3	0	0	1	0	0	0	4
OG0007128	2	1	0	1	0	0	0	4
OG0007129	3	0	0	0	0	1	0	4
OG0007130	2	1	1	0	0	0	0	4
OG0007131	2	1	1	0	0	0	0	4
OG0007132	2	1	0	1	0	0	0	4
OG0007133	2	1	1	0	0	0	0	4
OG0007134	4	0	0	0	0	0	0	4
OG0007135	2	1	1	0	0	0	0	4
OG0007136	2	0	1	1	0	0	0	4
OG0007137	4	0	0	0	0	0	0	4
OG0007138	3	0	0	0	0	1	0	4
OG0007139	4	0	0	0	0	0	0	4
OG0007140	1	1	1	1	0	0	0	4
OG0007141	2	1	1	0	0	0	0	4
OG0007142	2	1	1	0	0	0	0	4
OG0007143	4	0	0	0	0	0	0	4
OG0007144	2	1	1	0	0	0	0	4
OG0007145	3	0	0	0	0	1	0	4
OG0007146	2	1	1	0	0	0	0	4
OG0007147	3	0	0	1	0	0	0	4
OG0007148	2	1	1	0	0	0	0	4
OG0007149	4	0	0	0	0	0	0	4
OG0007150	2	0	1	0	0	1	0	4
OG0007151	4	0	0	0	0	0	0	4
OG0007152	2	0	1	1	0	0	0	4
OG0007153	1	1	1	1	0	0	0	4
OG0007154	4	0	0	0	0	0	0	4
OG0007155	1	1	1	1	0	0	0	4
OG0007156	3	0	0	0	0	1	0	4
OG0007157	4	0	0	0	0	0	0	4
OG0007158	3	0	0	0	0	0	1	4
OG0007159	1	1	1	1	0	0	0	4
OG0007160	2	1	1	0	0	0	0	4
OG0007161	2	1	1	0	0	0	0	4
OG0007162	2	0	0	1	0	1	0	4
OG0007163	3	0	1	0	0	0	0	4
OG0007164	1	1	1	1	0	0	0	4
OG0007165	2	1	0	1	0	0	0	4
OG0007166	2	1	1	0	0	0	0	4
OG0007167	2	0	1	1	0	0	0	4
OG0007168	2	0	1	1	0	0	0	4
OG0007169	2	1	1	0	0	0	0	4
OG0007170	4	0	0	0	0	0	0	4
OG0007171	2	1	1	0	0	0	0	4
OG0007172	2	1	1	0	0	0	0	4
OG0007173	2	0	2	0	0	0	0	4
OG0007174	2	1	1	0	0	0	0	4
OG0007175	4	0	0	0	0	0	0	4
OG0007176	4	0	0	0	0	0	0	4
OG0007177	4	0	0	0	0	0	0	4
OG0007178	4	0	0	0	0	0	0	4
OG0007179	4	0	0	0	0	0	0	4
OG0007180	2	1	1	0	0	0	0	4
OG0007181	4	0	0	0	0	0	0	4
OG0007182	2	0	1	1	0	0	0	4
OG0007183	2	1	1	0	0	0	0	4
OG0007184	2	1	1	0	0	0	0	4
OG0007185	2	0	2	0	0	0	0	4
OG0007186	2	0	1	1	0	0	0	4
OG0007187	2	1	1	0	0	0	0	4
OG0007188	2	0	1	1	0	0	0	4
OG0007189	2	1	1	0	0	0	0	4
OG0007190	2	0	1	1	0	0	0	4
OG0007191	2	1	0	1	0	0	0	4
OG0007192	2	1	1	0	0	0	0	4
OG0007193	2	1	0	1	0	0	0	4
OG0007194	4	0	0	0	0	0	0	4
OG0007195	2	0	1	1	0	0	0	4
OG0007196	2	0	1	1	0	0	0	4
OG0007197	2	1	1	0	0	0	0	4
OG0007198	2	1	1	0	0	0	0	4
OG0007199	2	1	1	0	0	0	0	4
OG0007200	2	1	1	0	0	0	0	4
OG0007201	1	0	2	1	0	0	0	4
OG0007202	4	0	0	0	0	0	0	4
OG0007203	2	0	1	1	0	0	0	4
OG0007204	1	1	1	1	0	0	0	4
OG0007205	2	1	0	1	0	0	0	4
OG0007206	2	1	0	1	0	0	0	4
OG0007207	2	1	0	1	0	0	0	4
OG0007208	4	0	0	0	0	0	0	4
OG0007209	2	1	0	1	0	0	0	4
OG0007210	4	0	0	0	0	0	0	4
OG0007211	2	1	1	0	0	0	0	4
OG0007212	1	1	1	1	0	0	0	4
OG0007213	2	0	1	0	0	1	0	4
OG0007214	3	0	1	0	0	0	0	4
OG0007215	4	0	0	0	0	0	0	4
OG0007216	3	0	0	0	0	0	1	4
OG0007217	1	1	1	1	0	0	0	4
OG0007218	4	0	0	0	0	0	0	4
OG0007219	2	0	1	1	0	0	0	4
OG0007220	1	1	1	1	0	0	0	4
OG0007221	2	1	1	0	0	0	0	4
OG0007222	2	1	1	0	0	0	0	4
OG0007223	2	1	1	0	0	0	0	4
OG0007224	1	1	0	1	0	1	0	4
OG0007225	2	1	0	0	0	1	0	4
OG0007226	2	1	1	0	0	0	0	4
OG0007227	1	1	1	1	0	0	0	4
OG0007228	4	0	0	0	0	0	0	4
OG0007229	2	1	1	0	0	0	0	4
OG0007230	2	1	1	0	0	0	0	4
OG0007231	2	1	1	0	0	0	0	4
OG0007232	3	0	1	0	0	0	0	4
OG0007233	1	1	2	0	0	0	0	4
OG0007234	2	0	1	1	0	0	0	4
OG0007235	2	0	1	1	0	0	0	4
OG0007236	4	0	0	0	0	0	0	4
OG0007237	4	0	0	0	0	0	0	4
OG0007238	2	0	1	0	0	1	0	4
OG0007239	4	0	0	0	0	0	0	4
OG0007240	2	0	1	1	0	0	0	4
OG0007241	2	1	1	0	0	0	0	4
OG0007242	2	0	1	1	0	0	0	4
OG0007243	2	1	0	1	0	0	0	4
OG0007244	4	0	0	0	0	0	0	4
OG0007245	1	1	1	1	0	0	0	4
OG0007246	2	1	1	0	0	0	0	4
OG0007247	2	1	0	1	0	0	0	4
OG0007248	1	1	0	2	0	0	0	4
OG0007249	2	1	1	0	0	0	0	4
OG0007250	1	1	1	1	0	0	0	4
OG0007251	4	0	0	0	0	0	0	4
OG0007252	4	0	0	0	0	0	0	4
OG0007253	4	0	0	0	0	0	0	4
OG0007254	2	1	0	0	0	1	0	4
OG0007255	4	0	0	0	0	0	0	4
OG0007256	1	1	1	1	0	0	0	4
OG0007257	1	1	1	1	0	0	0	4
OG0007258	2	0	1	1	0	0	0	4
OG0007259	3	0	0	1	0	0	0	4
OG0007260	3	0	1	0	0	0	0	4
OG0007261	2	0	1	0	0	1	0	4
OG0007262	2	1	1	0	0	0	0	4
OG0007263	2	0	1	1	0	0	0	4
OG0007264	2	1	1	0	0	0	0	4
OG0007265	2	1	1	0	0	0	0	4
OG0007266	2	1	1	0	0	0	0	4
OG0007267	2	0	1	0	0	1	0	4
OG0007268	2	0	0	0	0	1	1	4
OG0007269	2	0	2	0	0	0	0	4
OG0007270	4	0	0	0	0	0	0	4
OG0007271	2	0	1	1	0	0	0	4
OG0007272	2	0	1	1	0	0	0	4
OG0007273	1	1	2	0	0	0	0	4
OG0007274	2	0	1	1	0	0	0	4
OG0007275	2	1	0	1	0	0	0	4
OG0007276	2	1	1	0	0	0	0	4
OG0007277	4	0	0	0	0	0	0	4
OG0007278	2	1	1	0	0	0	0	4
OG0007279	1	1	1	1	0	0	0	4
OG0007280	4	0	0	0	0	0	0	4
OG0007281	2	0	1	1	0	0	0	4
OG0007282	2	0	1	1	0	0	0	4
OG0007283	4	0	0	0	0	0	0	4
OG0007284	2	1	0	1	0	0	0	4
OG0007285	2	1	1	0	0	0	0	4
OG0007286	4	0	0	0	0	0	0	4
OG0007287	2	0	1	0	0	1	0	4
OG0007288	2	0	0	0	0	2	0	4
OG0007289	2	1	1	0	0	0	0	4
OG0007290	2	1	1	0	0	0	0	4
OG0007291	4	0	0	0	0	0	0	4
OG0007292	2	1	1	0	0	0	0	4
OG0007293	2	0	1	1	0	0	0	4
OG0007294	4	0	0	0	0	0	0	4
OG0007295	3	0	1	0	0	0	0	4
OG0007296	2	1	1	0	0	0	0	4
OG0007297	1	1	1	0	0	1	0	4
OG0007298	4	0	0	0	0	0	0	4
OG0007299	1	1	0	0	2	0	0	4
OG0007300	1	1	1	1	0	0	0	4
OG0007301	1	1	0	1	0	1	0	4
OG0007302	1	1	1	0	0	1	0	4
OG0007303	1	1	1	1	0	0	0	4
OG0007304	4	0	0	0	0	0	0	4
OG0007305	2	1	1	0	0	0	0	4
OG0007306	4	0	0	0	0	0	0	4
OG0007307	2	1	1	0	0	0	0	4
OG0007308	2	1	1	0	0	0	0	4
OG0007309	2	0	1	1	0	0	0	4
OG0007310	2	1	1	0	0	0	0	4
OG0007311	2	1	1	0	0	0	0	4
OG0007312	2	1	0	1	0	0	0	4
OG0007313	2	1	1	0	0	0	0	4
OG0007314	4	0	0	0	0	0	0	4
OG0007315	2	1	1	0	0	0	0	4
OG0007316	4	0	0	0	0	0	0	4
OG0007317	2	0	1	0	0	1	0	4
OG0007318	3	1	0	0	0	0	0	4
OG0007319	4	0	0	0	0	0	0	4
OG0007320	2	1	1	0	0	0	0	4
OG0007321	2	1	1	0	0	0	0	4
OG0007322	2	1	1	0	0	0	0	4
OG0007323	4	0	0	0	0	0	0	4
OG0007324	2	0	1	1	0	0	0	4
OG0007325	4	0	0	0	0	0	0	4
OG0007326	1	1	1	1	0	0	0	4
OG0007327	1	1	1	1	0	0	0	4
OG0007328	2	0	1	0	0	1	0	4
OG0007329	2	0	1	1	0	0	0	4
OG0007330	4	0	0	0	0	0	0	4
OG0007331	2	0	1	1	0	0	0	4
OG0007332	4	0	0	0	0	0	0	4
OG0007333	2	0	1	1	0	0	0	4
OG0007334	4	0	0	0	0	0	0	4
OG0007335	2	1	0	1	0	0	0	4
OG0007336	2	1	1	0	0	0	0	4
OG0007337	2	1	1	0	0	0	0	4
OG0007338	2	1	1	0	0	0	0	4
OG0007339	1	1	1	1	0	0	0	4
OG0007340	4	0	0	0	0	0	0	4
OG0007341	1	1	1	1	0	0	0	4
OG0007342	2	0	1	1	0	0	0	4
OG0007343	2	0	1	1	0	0	0	4
OG0007344	1	3	0	0	0	0	0	4
OG0007345	2	1	0	0	0	1	0	4
OG0007346	1	1	1	1	0	0	0	4
OG0007347	2	0	0	0	0	1	1	4
OG0007348	3	0	1	0	0	0	0	4
OG0007349	2	0	0	0	1	0	1	4
OG0007350	4	0	0	0	0	0	0	4
OG0007351	2	1	0	0	0	1	0	4
OG0007352	2	1	0	1	0	0	0	4
OG0007353	2	1	1	0	0	0	0	4
OG0007354	1	0	0	0	0	0	3	4
OG0007355	2	1	0	1	0	0	0	4
OG0007356	2	1	1	0	0	0	0	4
OG0007357	1	1	1	1	0	0	0	4
OG0007358	2	0	1	1	0	0	0	4
OG0007359	2	1	0	1	0	0	0	4
OG0007360	3	0	1	0	0	0	0	4
OG0007361	4	0	0	0	0	0	0	4
OG0007362	4	0	0	0	0	0	0	4
OG0007363	1	1	0	1	0	1	0	4
OG0007364	1	1	1	1	0	0	0	4
OG0007365	2	0	2	0	0	0	0	4
OG0007366	2	1	0	0	0	1	0	4
OG0007367	2	1	1	0	0	0	0	4
OG0007368	1	2	1	0	0	0	0	4
OG0007369	4	0	0	0	0	0	0	4
OG0007370	1	0	0	0	1	1	1	4
OG0007371	4	0	0	0	0	0	0	4
OG0007372	1	1	1	1	0	0	0	4
OG0007373	4	0	0	0	0	0	0	4
OG0007374	2	1	1	0	0	0	0	4
OG0007375	2	0	1	1	0	0	0	4
OG0007376	4	0	0	0	0	0	0	4
OG0007377	4	0	0	0	0	0	0	4
OG0007378	4	0	0	0	0	0	0	4
OG0007379	4	0	0	0	0	0	0	4
OG0007380	4	0	0	0	0	0	0	4
OG0007381	2	0	1	0	0	1	0	4
OG0007382	2	1	1	0	0	0	0	4
OG0007383	2	0	1	1	0	0	0	4
OG0007384	2	1	1	0	0	0	0	4
OG0007385	2	1	1	0	0	0	0	4
OG0007386	4	0	0	0	0	0	0	4
OG0007387	1	1	1	1	0	0	0	4
OG0007388	1	2	1	0	0	0	0	4
OG0007389	1	1	0	1	0	1	0	4
OG0007390	4	0	0	0	0	0	0	4
OG0007391	2	1	1	0	0	0	0	4
OG0007392	1	1	1	1	0	0	0	4
OG0007393	2	1	0	0	0	1	0	4
OG0007394	1	1	1	1	0	0	0	4
OG0007395	1	1	2	0	0	0	0	4
OG0007396	2	1	1	0	0	0	0	4
OG0007397	1	0	1	0	0	1	1	4
OG0007398	4	0	0	0	0	0	0	4
OG0007399	1	1	1	1	0	0	0	4
OG0007400	1	1	1	0	0	1	0	4
OG0007401	1	0	0	0	1	1	1	4
OG0007402	1	1	1	1	0	0	0	4
OG0007403	1	1	1	1	0	0	0	4
OG0007404	4	0	0	0	0	0	0	4
OG0007405	1	1	1	1	0	0	0	4
OG0007406	1	1	1	1	0	0	0	4
OG0007407	2	1	0	1	0	0	0	4
OG0007408	2	1	1	0	0	0	0	4
OG0007409	1	1	1	1	0	0	0	4
OG0007410	4	0	0	0	0	0	0	4
OG0007411	2	1	0	1	0	0	0	4
OG0007412	4	0	0	0	0	0	0	4
OG0007413	3	0	1	0	0	0	0	4
OG0007414	2	0	1	0	0	0	1	4
OG0007415	2	1	0	1	0	0	0	4
OG0007416	2	0	1	1	0	0	0	4
OG0007417	3	0	1	0	0	0	0	4
OG0007418	2	1	0	0	0	1	0	4
OG0007419	2	1	1	0	0	0	0	4
OG0007420	4	0	0	0	0	0	0	4
OG0007421	2	1	1	0	0	0	0	4
OG0007422	1	1	1	0	0	0	1	4
OG0007423	1	1	1	1	0	0	0	4
OG0007424	4	0	0	0	0	0	0	4
OG0007425	2	0	1	1	0	0	0	4
OG0007426	2	0	1	0	0	1	0	4
OG0007427	2	0	1	1	0	0	0	4
OG0007428	2	0	1	1	0	0	0	4
OG0007429	3	0	1	0	0	0	0	4
OG0007430	2	0	1	0	1	0	0	4
OG0007431	3	0	1	0	0	0	0	4
OG0007432	2	1	1	0	0	0	0	4
OG0007433	1	0	1	1	0	1	0	4
OG0007434	2	0	1	1	0	0	0	4
OG0007435	2	0	1	1	0	0	0	4
OG0007436	4	0	0	0	0	0	0	4
OG0007437	2	0	1	1	0	0	0	4
OG0007438	1	1	1	1	0	0	0	4
OG0007439	1	1	1	1	0	0	0	4
OG0007440	1	1	1	1	0	0	0	4
OG0007441	1	1	1	1	0	0	0	4
OG0007442	2	1	1	0	0	0	0	4
OG0007443	1	1	1	1	0	0	0	4
OG0007444	2	0	1	1	0	0	0	4
OG0007445	1	1	1	1	0	0	0	4
OG0007446	1	1	1	1	0	0	0	4
OG0007447	1	0	2	1	0	0	0	4
OG0007448	1	1	1	1	0	0	0	4
OG0007449	1	1	1	1	0	0	0	4
OG0007450	1	1	1	1	0	0	0	4
OG0007451	1	1	1	1	0	0	0	4
OG0007452	1	1	1	1	0	0	0	4
OG0007453	1	1	1	1	0	0	0	4
OG0007454	1	1	1	1	0	0	0	4
OG0007455	1	1	1	1	0	0	0	4
OG0007456	0	2	2	0	0	0	0	4
OG0007457	0	2	1	1	0	0	0	4
OG0007458	0	4	0	0	0	0	0	4
OG0007459	0	4	0	0	0	0	0	4
OG0007460	0	1	1	1	0	1	0	4
OG0007461	0	4	0	0	0	0	0	4
OG0007462	0	2	2	0	0	0	0	4
OG0007463	0	4	0	0	0	0	0	4
OG0007464	0	1	1	1	0	1	0	4
OG0007465	0	1	2	1	0	0	0	4
OG0007466	0	4	0	0	0	0	0	4
OG0007467	0	2	1	1	0	0	0	4
OG0007468	0	1	0	1	0	2	0	4
OG0007469	0	1	1	0	1	0	1	4
OG0007470	0	1	0	1	0	0	2	4
OG0007471	0	1	0	1	0	1	1	4
OG0007472	0	1	1	1	0	1	0	4
OG0007473	0	1	1	1	0	1	0	4
OG0007474	0	1	1	2	0	0	0	4
OG0007475	0	1	0	1	0	1	1	4
OG0007476	0	4	0	0	0	0	0	4
OG0007477	0	1	1	1	0	1	0	4
OG0007478	0	1	1	2	0	0	0	4
OG0007479	0	1	1	2	0	0	0	4
OG0007480	0	1	1	2	0	0	0	4
OG0007481	0	4	0	0	0	0	0	4
OG0007482	0	1	1	1	0	1	0	4
OG0007483	0	3	1	0	0	0	0	4
OG0007484	0	1	0	3	0	0	0	4
OG0007485	0	4	0	0	0	0	0	4
OG0007486	0	1	1	1	0	1	0	4
OG0007487	0	1	2	1	0	0	0	4
OG0007488	0	1	2	1	0	0	0	4
OG0007489	0	1	1	1	1	0	0	4
OG0007490	0	1	1	1	0	1	0	4
OG0007491	0	1	1	1	0	1	0	4
OG0007492	0	4	0	0	0	0	0	4
OG0007493	0	4	0	0	0	0	0	4
OG0007494	0	4	0	0	0	0	0	4
OG0007495	0	1	1	1	0	1	0	4
OG0007496	0	1	1	1	0	1	0	4
OG0007497	0	1	1	0	0	1	1	4
OG0007498	0	1	1	0	0	2	0	4
OG0007499	0	1	1	1	0	1	0	4
OG0007500	0	1	1	2	0	0	0	4
OG0007501	0	1	0	0	1	1	1	4
OG0007502	0	1	2	1	0	0	0	4
OG0007503	0	1	1	2	0	0	0	4
OG0007504	0	1	1	1	0	1	0	4
OG0007505	0	1	1	1	0	0	1	4
OG0007506	0	1	1	1	0	1	0	4
OG0007507	0	1	1	1	0	1	0	4
OG0007508	0	1	1	2	0	0	0	4
OG0007509	0	1	0	0	2	0	1	4
OG0007510	0	1	1	2	0	0	0	4
OG0007511	0	1	0	0	2	0	1	4
OG0007512	0	1	0	3	0	0	0	4
OG0007513	0	4	0	0	0	0	0	4
OG0007514	0	4	0	0	0	0	0	4
OG0007515	0	1	1	1	0	1	0	4
OG0007516	0	1	1	0	0	1	1	4
OG0007517	0	1	1	2	0	0	0	4
OG0007518	0	1	1	2	0	0	0	4
OG0007519	0	1	1	1	0	0	1	4
OG0007520	0	1	1	0	1	1	0	4
OG0007521	0	1	1	2	0	0	0	4
OG0007522	0	1	3	0	0	0	0	4
OG0007523	0	1	1	1	0	1	0	4
OG0007524	0	4	0	0	0	0	0	4
OG0007525	0	1	1	2	0	0	0	4
OG0007526	0	1	1	1	0	1	0	4
OG0007527	0	1	1	1	0	0	1	4
OG0007528	0	1	1	1	0	1	0	4
OG0007529	0	1	1	2	0	0	0	4
OG0007530	0	0	4	0	0	0	0	4
OG0007531	0	0	4	0	0	0	0	4
OG0007532	0	0	4	0	0	0	0	4
OG0007533	0	0	1	0	1	1	1	4
OG0007534	0	0	4	0	0	0	0	4
OG0007535	0	0	4	0	0	0	0	4
OG0007536	0	0	4	0	0	0	0	4
OG0007537	0	0	1	0	1	1	1	4
OG0007538	0	0	3	1	0	0	0	4
OG0007539	0	0	1	3	0	0	0	4
OG0007540	0	0	4	0	0	0	0	4
OG0007541	0	0	4	0	0	0	0	4
OG0007542	0	0	4	0	0	0	0	4
OG0007543	0	0	4	0	0	0	0	4
OG0007544	0	0	1	1	0	1	1	4
OG0007545	0	0	1	3	0	0	0	4
OG0007546	0	0	4	0	0	0	0	4
OG0007547	0	0	1	0	1	1	1	4
OG0007548	0	0	4	0	0	0	0	4
OG0007549	0	0	4	0	0	0	0	4
OG0007550	0	0	4	0	0	0	0	4
OG0007551	0	0	4	0	0	0	0	4
OG0007552	0	0	1	0	1	1	1	4
OG0007553	0	0	4	0	0	0	0	4
OG0007554	0	0	1	1	0	1	1	4
OG0007555	0	0	4	0	0	0	0	4
OG0007556	0	0	4	0	0	0	0	4
OG0007557	0	0	2	1	0	1	0	4
OG0007558	0	0	3	1	0	0	0	4
OG0007559	0	0	1	1	0	2	0	4
OG0007560	0	0	4	0	0	0	0	4
OG0007561	0	0	4	0	0	0	0	4
OG0007562	0	0	1	0	1	1	1	4
OG0007563	0	0	4	0	0	0	0	4
OG0007564	0	0	4	0	0	0	0	4
OG0007565	0	0	1	1	1	0	1	4
OG0007566	0	0	4	0	0	0	0	4
OG0007567	0	0	1	3	0	0	0	4
OG0007568	0	0	1	3	0	0	0	4
OG0007569	0	0	4	0	0	0	0	4
OG0007570	0	0	4	0	0	0	0	4
OG0007571	0	0	4	0	0	0	0	4
OG0007572	0	0	4	0	0	0	0	4
OG0007573	0	0	2	1	0	0	1	4
OG0007574	0	0	4	0	0	0	0	4
OG0007575	0	0	4	0	0	0	0	4
OG0007576	0	0	4	0	0	0	0	4
OG0007577	0	0	0	4	0	0	0	4
OG0007578	0	0	0	4	0	0	0	4
OG0007579	0	0	0	4	0	0	0	4
OG0007580	0	0	0	4	0	0	0	4
OG0007581	0	0	0	4	0	0	0	4
OG0007582	0	0	0	4	0	0	0	4
OG0007583	0	0	0	4	0	0	0	4
OG0007584	0	0	0	4	0	0	0	4
OG0007585	0	0	0	4	0	0	0	4
OG0007586	0	0	0	4	0	0	0	4
OG0007587	0	0	0	4	0	0	0	4
OG0007588	0	0	0	4	0	0	0	4
OG0007589	0	0	0	4	0	0	0	4
OG0007590	0	0	0	4	0	0	0	4
OG0007591	0	0	0	4	0	0	0	4
OG0007592	0	0	0	4	0	0	0	4
OG0007593	0	0	0	4	0	0	0	4
OG0007594	0	0	0	4	0	0	0	4
OG0007595	0	0	0	4	0	0	0	4
OG0007596	0	0	0	4	0	0	0	4
OG0007597	0	0	0	4	0	0	0	4
OG0007598	0	0	0	4	0	0	0	4
OG0007599	0	0	0	4	0	0	0	4
OG0007600	0	0	0	4	0	0	0	4
OG0007601	0	0	0	4	0	0	0	4
OG0007602	0	0	0	4	0	0	0	4
OG0007603	0	0	0	4	0	0	0	4
OG0007604	0	0	0	4	0	0	0	4
OG0007605	0	0	0	4	0	0	0	4
OG0007606	0	0	0	4	0	0	0	4
OG0007607	0	0	0	4	0	0	0	4
OG0007608	0	0	0	4	0	0	0	4
OG0007609	0	0	0	4	0	0	0	4
OG0007610	0	0	0	4	0	0	0	4
OG0007611	0	0	0	4	0	0	0	4
OG0007612	0	0	0	4	0	0	0	4
OG0007613	0	0	0	4	0	0	0	4
OG0007614	0	0	0	4	0	0	0	4
OG0007615	0	0	0	4	0	0	0	4
OG0007616	0	0	0	4	0	0	0	4
OG0007617	0	0	0	4	0	0	0	4
OG0007618	0	0	0	4	0	0	0	4
OG0007619	0	0	0	4	0	0	0	4
OG0007620	0	0	0	4	0	0	0	4
OG0007621	0	0	0	4	0	0	0	4
OG0007622	0	0	0	4	0	0	0	4
OG0007623	0	0	0	4	0	0	0	4
OG0007624	0	0	0	4	0	0	0	4
OG0007625	0	0	0	1	1	1	1	4
OG0007626	0	0	0	4	0	0	0	4
OG0007627	0	0	0	4	0	0	0	4
OG0007628	0	0	0	4	0	0	0	4
OG0007629	0	0	0	4	0	0	0	4
OG0007630	0	0	0	4	0	0	0	4
OG0007631	0	0	0	3	0	1	0	4
OG0007632	0	0	0	4	0	0	0	4
OG0007633	0	0	0	4	0	0	0	4
OG0007634	0	0	0	4	0	0	0	4
OG0007635	0	0	0	4	0	0	0	4
OG0007636	0	0	0	4	0	0	0	4
OG0007637	0	0	0	1	0	3	0	4
OG0007638	0	0	0	4	0	0	0	4
OG0007639	0	0	0	1	1	1	1	4
OG0007640	0	0	0	1	3	0	0	4
OG0007641	0	0	0	0	2	0	2	4
OG0007642	0	0	0	0	3	0	1	4
OG0007643	0	0	0	0	4	0	0	4
OG0007644	0	0	0	0	2	0	2	4
OG0007645	0	0	0	0	1	1	2	4
OG0007646	0	0	0	0	1	0	3	4
OG0007647	0	0	0	0	4	0	0	4
OG0007648	0	0	0	0	3	0	1	4
OG0007649	0	0	0	0	3	1	0	4
OG0007650	0	0	0	0	4	0	0	4
OG0007651	0	0	0	0	1	0	3	4
OG0007652	0	0	0	0	4	0	0	4
OG0007653	0	0	0	0	2	1	1	4
OG0007654	0	0	0	0	1	1	2	4
OG0007655	0	0	0	0	2	0	2	4
OG0007656	0	0	0	0	1	0	3	4
OG0007657	0	0	0	0	4	0	0	4
OG0007658	0	0	0	0	1	1	2	4
OG0007659	0	0	0	0	4	0	0	4
OG0007660	0	0	0	0	4	0	0	4
OG0007661	0	0	0	0	1	0	3	4
OG0007662	0	0	0	0	3	0	1	4
OG0007663	0	0	0	0	4	0	0	4
OG0007664	0	0	0	0	1	0	3	4
OG0007665	0	0	0	0	3	0	1	4
OG0007666	0	0	0	0	2	0	2	4
OG0007667	0	0	0	0	4	0	0	4
OG0007668	0	0	0	0	3	0	1	4
OG0007669	0	0	0	0	3	0	1	4
OG0007670	0	0	0	0	2	0	2	4
OG0007671	0	0	0	0	2	1	1	4
OG0007672	0	0	0	0	2	0	2	4
OG0007673	0	0	0	0	3	0	1	4
OG0007674	0	0	0	0	3	0	1	4
OG0007675	0	0	0	0	2	0	2	4
OG0007676	0	0	0	0	3	0	1	4
OG0007677	0	0	0	0	2	1	1	4
OG0007678	0	0	0	0	2	1	1	4
OG0007679	0	0	0	0	2	0	2	4
OG0007680	0	0	0	0	4	0	0	4
OG0007681	0	0	0	0	1	0	3	4
OG0007682	0	0	0	0	2	0	2	4
OG0007683	0	0	0	0	3	0	1	4
OG0007684	0	0	0	0	3	0	1	4
OG0007685	0	0	0	0	2	0	2	4
OG0007686	0	0	0	0	2	1	1	4
OG0007687	0	0	0	0	2	1	1	4
OG0007688	0	0	0	0	1	0	3	4
OG0007689	0	0	0	0	1	2	1	4
OG0007690	0	0	0	0	2	0	2	4
OG0007691	0	0	0	0	1	0	3	4
OG0007692	0	0	0	0	3	0	1	4
OG0007693	0	0	0	0	2	0	2	4
OG0007694	0	0	0	0	3	0	1	4
OG0007695	0	0	0	0	1	2	1	4
OG0007696	0	0	0	0	3	0	1	4
OG0007697	0	0	0	0	1	0	3	4
OG0007698	0	0	0	0	3	0	1	4
OG0007699	0	0	0	0	2	1	1	4
OG0007700	0	0	0	0	4	0	0	4
OG0007701	0	0	0	0	2	1	1	4
OG0007702	0	0	0	0	3	0	1	4
OG0007703	0	0	0	0	2	0	2	4
OG0007704	0	0	0	0	1	0	3	4
OG0007705	0	0	0	0	4	0	0	4
OG0007706	0	0	0	0	3	0	1	4
OG0007707	0	0	0	0	4	0	0	4
OG0007708	0	0	0	0	3	0	1	4
OG0007709	0	0	0	0	1	1	2	4
OG0007710	0	0	0	0	2	1	1	4
OG0007711	0	0	0	0	2	0	2	4
OG0007712	0	0	0	0	3	0	1	4
OG0007713	0	0	0	0	4	0	0	4
OG0007714	0	0	0	0	3	0	1	4
OG0007715	0	0	0	0	2	1	1	4
OG0007716	0	0	0	0	3	0	1	4
OG0007717	0	0	0	0	1	0	3	4
OG0007718	0	0	0	0	3	0	1	4
OG0007719	0	0	0	0	3	0	1	4
OG0007720	0	0	0	0	2	1	1	4
OG0007721	0	0	0	0	1	1	2	4
OG0007722	0	0	0	0	3	0	1	4
OG0007723	0	0	0	0	3	0	1	4
OG0007724	0	0	0	0	1	0	3	4
OG0007725	0	0	0	0	1	0	3	4
OG0007726	0	0	0	0	3	0	1	4
OG0007727	0	0	0	0	2	0	2	4
OG0007728	0	0	0	0	1	0	3	4
OG0007729	0	0	0	0	3	0	1	4
OG0007730	0	0	0	0	3	0	1	4
OG0007731	0	0	0	0	1	1	2	4
OG0007732	0	0	0	0	2	1	1	4
OG0007733	0	0	0	0	1	0	3	4
OG0007734	0	0	0	0	2	1	1	4
OG0007735	0	0	0	0	3	0	1	4
OG0007736	0	0	0	0	2	0	2	4
OG0007737	0	0	0	0	1	0	3	4
OG0007738	0	0	0	0	2	0	2	4
OG0007739	0	0	0	0	1	0	3	4
OG0007740	0	0	0	0	1	0	3	4
OG0007741	0	0	0	0	1	0	3	4
OG0007742	0	0	0	0	1	0	3	4
OG0007743	0	0	0	0	2	0	2	4
OG0007744	0	0	0	0	1	0	3	4
OG0007745	0	0	0	0	4	0	0	4
OG0007746	0	0	0	0	2	0	2	4
OG0007747	0	0	0	0	4	0	0	4
OG0007748	0	0	0	0	3	0	1	4
OG0007749	0	0	0	0	2	1	1	4
OG0007750	0	0	0	0	2	0	2	4
OG0007751	0	0	0	0	2	1	1	4
OG0007752	0	0	0	0	2	0	2	4
OG0007753	0	0	0	0	1	0	3	4
OG0007754	0	0	0	0	2	0	2	4
OG0007755	0	0	0	0	3	0	1	4
OG0007756	0	0	0	0	3	0	1	4
OG0007757	0	0	0	0	3	0	1	4
OG0007758	0	0	0	0	1	1	2	4
OG0007759	0	0	0	0	2	0	2	4
OG0007760	0	0	0	0	2	0	2	4
OG0007761	0	0	0	0	3	0	1	4
OG0007762	0	0	0	0	1	0	3	4
OG0007763	0	0	0	0	2	1	1	4
OG0007764	0	0	0	0	1	1	2	4
OG0007765	0	0	0	0	2	1	1	4
OG0007766	0	0	0	0	2	1	1	4
OG0007767	0	0	0	0	2	0	2	4
OG0007768	0	0	0	0	3	0	1	4
OG0007769	0	0	0	0	1	1	2	4
OG0007770	0	0	0	0	2	0	2	4
OG0007771	0	0	0	0	2	0	2	4
OG0007772	0	0	0	0	1	0	3	4
OG0007773	0	0	0	0	1	0	3	4
OG0007774	0	0	0	0	1	1	2	4
OG0007775	0	0	0	0	1	0	3	4
OG0007776	0	0	0	0	1	0	3	4
OG0007777	0	0	0	0	4	0	0	4
OG0007778	0	0	0	0	2	0	2	4
OG0007779	0	0	0	0	1	1	2	4
OG0007780	0	0	0	0	1	0	3	4
OG0007781	0	0	0	0	1	1	2	4
OG0007782	0	0	0	0	2	0	2	4
OG0007783	0	0	0	0	3	0	1	4
OG0007784	0	0	0	0	2	1	1	4
OG0007785	0	0	0	0	2	1	1	4
OG0007786	0	0	0	0	1	0	3	4
OG0007787	0	0	0	0	1	0	3	4
OG0007788	0	0	0	0	1	0	3	4
OG0007789	0	0	0	0	1	0	3	4
OG0007790	0	0	0	0	1	0	3	4
OG0007791	0	0	0	0	1	0	3	4
OG0007792	0	0	0	0	2	1	1	4
OG0007793	0	0	0	0	1	1	2	4
OG0007794	0	0	0	0	2	1	1	4
OG0007795	0	0	0	0	1	1	2	4
OG0007796	0	0	0	0	2	0	2	4
OG0007797	0	0	0	0	2	0	2	4
OG0007798	0	0	0	0	1	0	3	4
OG0007799	0	0	0	0	1	0	3	4
OG0007800	0	0	0	0	1	0	3	4
OG0007801	0	0	0	0	1	0	3	4
OG0007802	0	0	0	0	1	0	3	4
OG0007803	0	0	0	0	1	1	2	4
OG0007804	0	0	0	0	1	0	3	4
OG0007805	0	0	0	0	1	0	3	4
OG0007806	0	0	0	0	1	0	3	4
OG0007807	0	0	0	0	1	0	3	4
OG0007808	0	0	0	0	1	0	3	4
OG0007809	0	0	0	0	2	0	2	4
OG0007810	0	0	0	0	1	0	3	4
OG0007811	0	0	0	0	2	1	1	4
OG0007812	0	0	0	0	2	0	2	4
OG0007813	0	0	0	0	1	0	3	4
OG0007814	0	0	0	0	1	0	3	4
OG0007815	0	0	0	0	2	0	2	4
OG0007816	0	0	0	0	1	0	3	4
OG0007817	0	0	0	0	1	0	3	4
OG0007818	0	0	0	0	2	0	2	4
OG0007819	0	0	0	0	1	0	3	4
OG0007820	0	0	0	0	2	1	1	4
OG0007821	0	0	0	0	2	0	2	4
OG0007822	0	0	0	0	1	0	3	4
OG0007823	0	0	0	0	1	1	2	4
OG0007824	0	0	0	0	2	0	2	4
OG0007825	0	0	0	0	1	0	3	4
OG0007826	0	0	0	0	3	0	1	4
OG0007827	0	0	0	0	1	0	3	4
OG0007828	0	0	0	0	1	0	3	4
OG0007829	0	0	0	0	3	0	1	4
OG0007830	0	0	0	0	1	0	3	4
OG0007831	0	0	0	0	3	0	1	4
OG0007832	0	0	0	0	3	0	1	4
OG0007833	0	0	0	0	1	0	3	4
OG0007834	0	0	0	0	1	2	1	4
OG0007835	0	0	0	0	1	0	3	4
OG0007836	0	0	0	0	3	0	1	4
OG0007837	0	0	0	0	2	0	2	4
OG0007838	0	0	0	0	2	0	2	4
OG0007839	0	0	0	0	1	0	3	4
OG0007840	0	0	0	0	1	0	3	4
OG0007841	0	0	0	0	1	0	3	4
OG0007842	0	0	0	0	1	0	3	4
OG0007843	0	0	0	0	1	0	3	4
OG0007844	0	0	0	0	1	0	3	4
OG0007845	0	0	0	0	2	0	2	4
OG0007846	0	0	0	0	1	0	3	4
OG0007847	0	0	0	0	1	0	3	4
OG0007848	0	0	0	0	2	1	1	4
OG0007849	0	0	0	0	1	0	3	4
OG0007850	0	0	0	0	2	0	2	4
OG0007851	0	0	0	0	1	0	3	4
OG0007852	0	0	0	0	1	1	2	4
OG0007853	0	0	0	0	1	0	3	4
OG0007854	0	0	0	0	1	1	2	4
OG0007855	0	0	0	0	2	1	1	4
OG0007856	0	0	0	0	2	1	1	4
OG0007857	0	0	0	0	1	0	3	4
OG0007858	0	0	0	0	1	0	3	4
OG0007859	0	0	0	0	1	0	3	4
OG0007860	0	0	0	0	1	0	3	4
OG0007861	0	0	0	0	1	0	3	4
OG0007862	0	0	0	0	1	0	3	4
OG0007863	0	0	0	0	1	0	3	4
OG0007864	0	0	0	0	1	1	2	4
OG0007865	0	0	0	0	2	0	2	4
OG0007866	0	0	0	0	1	0	3	4
OG0007867	0	0	0	0	2	0	2	4
OG0007868	0	0	0	0	2	1	1	4
OG0007869	0	0	0	0	1	0	3	4
OG0007870	0	0	0	0	1	2	1	4
OG0007871	0	0	0	0	2	0	2	4
OG0007872	0	0	0	0	3	0	1	4
OG0007873	0	0	0	0	2	0	2	4
OG0007874	0	0	0	0	1	0	3	4
OG0007875	0	0	0	0	1	0	3	4
OG0007876	0	0	0	0	2	0	2	4
OG0007877	0	0	0	0	1	0	3	4
OG0007878	0	0	0	0	1	2	1	4
OG0007879	0	0	0	0	2	1	1	4
OG0007880	0	0	0	0	4	0	0	4
OG0007881	0	0	0	0	1	0	3	4
OG0007882	0	0	0	0	2	0	2	4
OG0007883	0	0	0	0	1	0	3	4
OG0007884	0	0	0	0	1	2	1	4
OG0007885	0	0	0	0	1	0	3	4
OG0007886	0	0	0	0	1	0	3	4
OG0007887	0	0	0	0	1	1	2	4
OG0007888	0	0	0	0	3	0	1	4
OG0007889	0	0	0	0	1	0	3	4
OG0007890	0	0	0	0	1	0	3	4
OG0007891	0	0	0	0	1	0	3	4
OG0007892	0	0	0	0	3	0	1	4
OG0007893	0	0	0	0	1	2	1	4
OG0007894	0	0	0	0	1	0	3	4
OG0007895	0	0	0	0	1	2	1	4
OG0007896	0	0	0	0	1	0	3	4
OG0007897	0	0	0	0	1	0	3	4
OG0007898	0	0	0	0	1	0	3	4
OG0007899	0	0	0	0	1	0	3	4
OG0007900	0	0	0	0	1	0	3	4
OG0007901	0	0	0	0	1	0	3	4
OG0007902	0	0	0	0	1	0	3	4
OG0007903	0	0	0	0	1	2	1	4
OG0007904	0	0	0	0	1	0	3	4
OG0007905	0	0	0	0	2	0	2	4
OG0007906	0	0	0	0	1	0	3	4
OG0007907	0	0	0	0	1	1	2	4
OG0007908	0	0	0	0	1	1	2	4
OG0007909	0	0	0	0	3	0	1	4
OG0007910	0	0	0	0	1	0	3	4
OG0007911	0	0	0	0	2	0	2	4
OG0007912	0	0	0	0	1	0	3	4
OG0007913	0	0	0	0	1	1	2	4
OG0007914	0	0	0	0	1	1	2	4
OG0007915	0	0	0	0	1	3	0	4
OG0007916	0	0	0	0	1	0	3	4
OG0007917	0	0	0	0	1	0	3	4
OG0007918	0	0	0	0	1	0	3	4
OG0007919	0	0	0	0	1	0	3	4
OG0007920	0	0	0	0	2	0	2	4
OG0007921	0	0	0	0	1	0	3	4
OG0007922	0	0	0	0	1	0	3	4
OG0007923	0	0	0	0	1	0	3	4
OG0007924	0	0	0	0	1	0	3	4
OG0007925	0	0	0	0	1	0	3	4
OG0007926	0	0	0	0	1	0	3	4
OG0007927	0	0	0	0	1	0	3	4
OG0007928	0	0	0	0	2	0	2	4
OG0007929	0	0	0	0	1	0	3	4
OG0007930	0	0	0	0	1	2	1	4
OG0007931	0	0	0	0	1	2	1	4
OG0007932	0	0	0	0	1	0	3	4
OG0007933	0	0	0	0	1	0	3	4
OG0007934	0	0	0	0	1	0	3	4
OG0007935	0	0	0	0	1	0	3	4
OG0007936	0	0	0	0	1	0	3	4
OG0007937	0	0	0	0	1	0	3	4
OG0007938	0	0	0	0	1	1	2	4
OG0007939	0	0	0	0	1	0	3	4
OG0007940	0	0	0	0	1	0	3	4
OG0007941	0	0	0	0	1	0	3	4
OG0007942	0	0	0	0	1	0	3	4
OG0007943	0	0	0	0	1	0	3	4
OG0007944	0	0	0	0	1	0	3	4
OG0007945	0	0	0	0	1	0	3	4
OG0007946	0	0	0	0	1	0	3	4
OG0007947	0	0	0	0	1	1	2	4
OG0007948	0	0	0	0	1	0	3	4
OG0007949	0	0	0	0	1	0	3	4
OG0007950	0	0	0	0	1	1	2	4
OG0007951	0	0	0	0	1	0	3	4
OG0007952	0	0	0	0	1	1	2	4
OG0007953	0	0	0	0	1	2	1	4
OG0007954	0	0	0	0	2	0	2	4
OG0007955	0	0	0	0	1	0	3	4
OG0007956	0	0	0	0	1	0	3	4
OG0007957	0	0	0	0	0	2	2	4
OG0007958	0	0	0	0	0	3	1	4
OG0007959	0	0	0	0	0	4	0	4
OG0007960	0	0	0	0	0	4	0	4
OG0007961	0	0	0	0	0	4	0	4
OG0007962	0	0	0	0	0	4	0	4
OG0007963	0	0	0	0	0	4	0	4
OG0007964	0	0	0	0	0	1	3	4
OG0007965	0	0	0	0	0	4	0	4
OG0007966	0	0	0	0	0	4	0	4
OG0007967	0	0	0	0	0	4	0	4
OG0007968	0	0	0	0	0	4	0	4
OG0007969	0	0	0	0	0	3	1	4
OG0007970	0	0	0	0	0	4	0	4
OG0007971	0	0	0	0	0	4	0	4
OG0007972	0	0	0	0	0	4	0	4
OG0007973	0	0	0	0	0	4	0	4
OG0007974	0	0	0	0	0	4	0	4
OG0007975	0	0	0	0	0	4	0	4
OG0007976	0	0	0	0	0	4	0	4
OG0007977	0	0	0	0	0	4	0	4
OG0007978	0	0	0	0	0	4	0	4
OG0007979	0	0	0	0	0	4	0	4
OG0007980	0	0	0	0	0	1	3	4
OG0007981	0	0	0	0	0	4	0	4
OG0007982	0	0	0	0	0	4	0	4
OG0007983	0	0	0	0	0	4	0	4
OG0007984	0	0	0	0	0	4	0	4
OG0007985	0	0	0	0	0	4	0	4
OG0007986	0	0	0	0	0	1	3	4
OG0007987	0	0	0	0	0	4	0	4
OG0007988	0	0	0	0	0	4	0	4
OG0007989	0	0	0	0	0	4	0	4
OG0007990	0	0	0	0	0	4	0	4
OG0007991	0	0	0	0	0	1	3	4
OG0007992	0	0	0	0	0	4	0	4
OG0007993	0	0	0	0	0	4	0	4
OG0007994	0	0	0	0	0	4	0	4
OG0007995	0	0	0	0	0	4	0	4
OG0007996	0	0	0	0	0	4	0	4
OG0007997	0	0	0	0	0	4	0	4
OG0007998	0	0	0	0	0	4	0	4
OG0007999	0	0	0	0	0	4	0	4
OG0008000	0	0	0	0	0	4	0	4
OG0008001	0	0	0	0	0	1	3	4
OG0008002	0	0	0	0	0	1	3	4
OG0008003	0	0	0	0	0	1	3	4
OG0008004	0	0	0	0	0	2	2	4
OG0008005	0	0	0	0	0	4	0	4
OG0008006	0	0	0	0	0	1	3	4
OG0008007	0	0	0	0	0	4	0	4
OG0008008	0	0	0	0	0	1	3	4
OG0008009	0	0	0	0	0	1	3	4
OG0008010	0	0	0	0	0	4	0	4
OG0008011	0	0	0	0	0	1	3	4
OG0008012	0	0	0	0	0	1	3	4
OG0008013	0	0	0	0	0	0	4	4
OG0008014	0	0	0	0	0	0	4	4
OG0008015	0	0	0	0	0	0	4	4
OG0008016	0	0	0	0	0	0	4	4
OG0008017	0	0	0	0	0	0	4	4
OG0008018	0	0	0	0	0	0	4	4
OG0008019	0	0	0	0	0	0	4	4
OG0008020	0	0	0	0	0	0	4	4
OG0008021	0	0	0	0	0	0	4	4
OG0008022	0	0	0	0	0	0	4	4
OG0008023	0	0	0	0	0	0	4	4
OG0008024	0	0	0	0	0	0	4	4
OG0008025	0	0	0	0	0	0	4	4
OG0008026	0	0	0	0	0	0	4	4
OG0008027	0	0	0	0	0	0	4	4
OG0008028	0	0	0	0	0	0	4	4
OG0008029	0	0	0	0	0	0	4	4
OG0008030	0	0	0	0	0	0	4	4
OG0008031	0	0	0	0	0	0	4	4
OG0008032	0	0	0	0	0	0	4	4
OG0008033	0	0	0	0	0	0	4	4
OG0008034	0	0	0	0	0	0	4	4
OG0008035	0	0	0	0	0	0	4	4
OG0008036	0	0	0	0	0	0	4	4
OG0008037	0	0	0	0	0	0	4	4
OG0008038	0	0	0	0	0	0	4	4
OG0008039	0	0	0	0	0	0	4	4
OG0008040	0	0	0	0	0	0	4	4
OG0008041	0	0	0	0	0	0	4	4
OG0008042	0	0	0	0	0	0	4	4
OG0008043	0	0	0	0	0	0	4	4
OG0008044	0	0	0	0	0	0	4	4
OG0008045	0	0	0	0	0	0	4	4
OG0008046	0	0	0	0	0	0	4	4
OG0008047	0	0	0	0	0	0	4	4
OG0008048	0	0	0	0	0	0	4	4
OG0008049	0	0	0	0	0	0	4	4
OG0008050	0	0	0	0	0	0	4	4
OG0008051	0	0	0	0	0	0	4	4
OG0008052	0	0	0	0	0	0	4	4
OG0008053	0	0	0	0	0	0	4	4
OG0008054	0	0	0	0	0	0	4	4
OG0008055	0	0	0	0	0	0	4	4
OG0008056	0	0	0	0	0	0	4	4
OG0008057	0	0	0	0	0	0	4	4
OG0008058	0	0	0	0	0	0	4	4
OG0008059	0	0	0	0	0	0	4	4
OG0008060	0	0	0	0	0	0	4	4
OG0008061	0	0	0	0	0	0	4	4
OG0008062	0	0	0	0	0	0	4	4
OG0008063	0	0	0	0	0	0	4	4
OG0008064	0	0	0	0	0	0	4	4
OG0008065	0	0	0	0	0	0	4	4
OG0008066	0	0	0	0	0	0	4	4
OG0008067	0	0	0	0	0	0	4	4
OG0008068	0	0	0	0	0	0	4	4
OG0008069	0	0	0	0	0	0	4	4
OG0008070	0	0	0	0	0	0	4	4
OG0008071	0	0	0	0	0	0	4	4
OG0008072	0	0	0	0	0	0	4	4
OG0008073	0	0	0	0	0	0	4	4
OG0008074	0	0	0	0	0	0	4	4
OG0008075	0	0	0	0	0	0	4	4
OG0008076	0	0	0	0	0	0	4	4
OG0008077	0	0	0	0	0	0	4	4
OG0008078	0	0	0	0	0	0	4	4
OG0008079	0	0	0	0	0	0	4	4
OG0008080	0	0	0	0	0	0	4	4
OG0008081	0	0	0	0	0	0	4	4
OG0008082	0	0	0	0	0	0	4	4
OG0008083	0	0	0	0	0	0	4	4
OG0008084	0	0	0	0	0	0	4	4
OG0008085	0	0	0	0	0	0	4	4
OG0008086	0	0	0	0	0	0	4	4
OG0008087	0	0	0	0	0	0	4	4
OG0008088	0	0	0	0	0	0	4	4
OG0008089	0	0	0	0	0	0	4	4
OG0008090	0	0	0	0	0	0	4	4
OG0008091	0	0	0	0	0	0	4	4
OG0008092	0	0	0	0	0	0	4	4
OG0008093	0	0	0	0	0	0	4	4
OG0008094	0	0	0	0	0	0	4	4
OG0008095	0	0	0	0	0	0	4	4
OG0008096	0	0	0	0	0	0	4	4
OG0008097	0	0	0	0	0	0	4	4
OG0008098	0	0	0	0	0	0	4	4
OG0008099	0	0	0	0	0	0	4	4
OG0008100	0	0	0	0	0	0	4	4
OG0008101	0	0	0	0	0	0	4	4
OG0008102	0	0	0	0	0	0	4	4
OG0008103	0	0	0	0	0	0	4	4
OG0008104	0	0	0	0	0	0	4	4
OG0008105	0	0	0	0	0	0	4	4
OG0008106	0	0	0	0	0	0	4	4
OG0008107	0	0	0	0	0	0	4	4
OG0008108	0	0	0	0	0	0	4	4
OG0008109	0	0	0	0	0	0	4	4
OG0008110	0	0	0	0	0	0	4	4
OG0008111	0	0	0	0	0	0	4	4
OG0008112	0	0	0	0	0	0	4	4
OG0008113	0	0	0	0	0	0	4	4
OG0008114	0	0	0	0	0	0	4	4
OG0008115	0	0	0	0	0	0	4	4
OG0008116	0	0	0	0	0	0	4	4
OG0008117	0	0	0	0	0	0	4	4
OG0008118	0	0	0	0	0	0	4	4
OG0008119	0	0	0	0	0	0	4	4
OG0008120	0	0	0	0	0	0	4	4
OG0008121	0	0	0	0	0	0	4	4
OG0008122	0	0	0	0	0	0	4	4
OG0008123	0	0	0	0	0	0	4	4
OG0008124	0	0	0	0	0	0	4	4
OG0008125	0	0	0	0	0	0	4	4
OG0008126	0	0	0	0	0	0	4	4
OG0008127	0	0	0	0	0	0	4	4
OG0008128	0	0	0	0	0	0	4	4
OG0008129	0	0	0	0	0	0	4	4
OG0008130	0	0	0	0	0	0	4	4
OG0008131	0	0	0	0	0	0	4	4
OG0008132	0	0	0	0	0	0	4	4
OG0008133	0	0	0	0	0	0	4	4
OG0008134	0	0	0	0	0	0	4	4
OG0008135	0	0	0	0	0	0	4	4
OG0008136	0	0	0	0	0	0	4	4
OG0008137	0	0	0	0	0	0	4	4
OG0008138	0	0	0	0	0	0	4	4
OG0008139	0	0	0	0	0	0	4	4
OG0008140	0	0	0	0	0	0	4	4
OG0008141	0	0	0	0	0	0	4	4
OG0008142	0	0	0	0	0	0	4	4
OG0008143	0	0	0	0	0	0	4	4
OG0008144	0	0	0	0	0	0	4	4
OG0008145	0	0	0	0	0	0	4	4
OG0008146	0	0	0	0	0	0	4	4
OG0008147	0	0	0	0	0	0	4	4
OG0008148	0	0	0	0	0	0	4	4
OG0008149	0	0	0	0	0	0	4	4
OG0008150	0	0	0	0	0	0	4	4
OG0008151	0	0	0	0	0	0	4	4
OG0008152	0	0	0	0	0	0	4	4
OG0008153	0	0	0	0	0	0	4	4
OG0008154	0	0	0	0	0	0	4	4
OG0008155	0	0	0	0	0	0	4	4
OG0008156	0	0	0	0	0	0	4	4
OG0008157	0	0	0	0	0	0	4	4
OG0008158	0	0	0	0	0	0	4	4
OG0008159	0	0	0	0	0	0	4	4
OG0008160	0	0	0	0	0	0	4	4
OG0008161	0	0	0	0	0	0	4	4
OG0008162	0	0	0	0	0	0	4	4
OG0008163	0	0	0	0	0	0	4	4
OG0008164	0	0	0	0	0	0	4	4
OG0008165	0	0	0	0	0	0	4	4
OG0008166	0	0	0	0	0	0	4	4
OG0008167	0	0	0	0	0	0	4	4
OG0008168	0	0	0	0	0	0	4	4
OG0008169	0	0	0	0	0	0	4	4
OG0008170	0	0	0	0	0	0	4	4
OG0008171	0	0	0	0	0	0	4	4
OG0008172	0	0	0	0	0	0	4	4
OG0008173	0	0	0	0	0	0	4	4
OG0008174	0	0	0	0	0	0	4	4
OG0008175	0	0	0	0	0	0	4	4
OG0008176	0	0	0	0	0	0	4	4
OG0008177	0	0	0	0	0	0	4	4
OG0008178	0	0	0	0	0	0	4	4
OG0008179	0	0	0	0	0	0	4	4
OG0008180	0	0	0	0	0	0	4	4
OG0008181	0	0	0	0	0	0	4	4
OG0008182	0	0	0	0	0	0	4	4
OG0008183	0	0	0	0	0	0	4	4
OG0008184	0	0	0	0	0	0	4	4
OG0008185	0	0	0	0	0	0	4	4
OG0008186	0	0	0	0	0	0	4	4
OG0008187	0	0	0	0	0	0	4	4
OG0008188	0	0	0	0	0	0	4	4
OG0008189	0	0	0	0	0	0	4	4
OG0008190	0	0	0	0	0	0	4	4
OG0008191	0	0	0	0	0	0	4	4
OG0008192	0	0	0	0	0	0	4	4
OG0008193	0	0	0	0	0	0	4	4
OG0008194	0	0	0	0	0	0	4	4
OG0008195	0	0	0	0	0	0	4	4
OG0008196	0	0	0	0	0	0	4	4
OG0008197	0	0	0	0	0	0	4	4
OG0008198	0	0	0	0	0	0	4	4
OG0008199	0	0	0	0	0	0	4	4
OG0008200	0	0	0	0	0	0	4	4
OG0008201	0	0	0	0	0	0	4	4
OG0008202	0	0	0	0	0	0	4	4
OG0008203	0	0	0	0	0	0	4	4
OG0008204	0	0	0	0	0	0	4	4
OG0008205	0	0	0	0	0	0	4	4
OG0008206	0	0	0	0	0	0	4	4
OG0008207	0	0	0	0	0	0	4	4
OG0008208	0	0	0	0	0	0	4	4
OG0008209	0	0	0	0	0	0	4	4
OG0008210	0	0	0	0	0	0	4	4
OG0008211	3	0	0	0	0	0	0	3
OG0008212	3	0	0	0	0	0	0	3
OG0008213	3	0	0	0	0	0	0	3
OG0008214	3	0	0	0	0	0	0	3
OG0008215	2	0	1	0	0	0	0	3
OG0008216	2	0	0	1	0	0	0	3
OG0008217	3	0	0	0	0	0	0	3
OG0008218	2	1	0	0	0	0	0	3
OG0008219	3	0	0	0	0	0	0	3
OG0008220	2	0	0	0	0	1	0	3
OG0008221	3	0	0	0	0	0	0	3
OG0008222	3	0	0	0	0	0	0	3
OG0008223	2	0	0	0	0	1	0	3
OG0008224	2	0	0	1	0	0	0	3
OG0008225	2	0	1	0	0	0	0	3
OG0008226	3	0	0	0	0	0	0	3
OG0008227	1	1	0	1	0	0	0	3
OG0008228	3	0	0	0	0	0	0	3
OG0008229	3	0	0	0	0	0	0	3
OG0008230	3	0	0	0	0	0	0	3
OG0008231	3	0	0	0	0	0	0	3
OG0008232	2	0	1	0	0	0	0	3
OG0008233	2	0	1	0	0	0	0	3
OG0008234	2	0	1	0	0	0	0	3
OG0008235	3	0	0	0	0	0	0	3
OG0008236	3	0	0	0	0	0	0	3
OG0008237	2	1	0	0	0	0	0	3
OG0008238	2	0	0	1	0	0	0	3
OG0008239	3	0	0	0	0	0	0	3
OG0008240	2	0	1	0	0	0	0	3
OG0008241	2	0	1	0	0	0	0	3
OG0008242	3	0	0	0	0	0	0	3
OG0008243	2	0	0	0	0	1	0	3
OG0008244	2	1	0	0	0	0	0	3
OG0008245	3	0	0	0	0	0	0	3
OG0008246	2	0	0	1	0	0	0	3
OG0008247	2	0	0	1	0	0	0	3
OG0008248	2	0	1	0	0	0	0	3
OG0008249	3	0	0	0	0	0	0	3
OG0008250	2	0	1	0	0	0	0	3
OG0008251	3	0	0	0	0	0	0	3
OG0008252	3	0	0	0	0	0	0	3
OG0008253	3	0	0	0	0	0	0	3
OG0008254	3	0	0	0	0	0	0	3
OG0008255	3	0	0	0	0	0	0	3
OG0008256	3	0	0	0	0	0	0	3
OG0008257	2	0	1	0	0	0	0	3
OG0008258	2	0	1	0	0	0	0	3
OG0008259	1	1	0	1	0	0	0	3
OG0008260	3	0	0	0	0	0	0	3
OG0008261	2	0	0	0	0	1	0	3
OG0008262	3	0	0	0	0	0	0	3
OG0008263	3	0	0	0	0	0	0	3
OG0008264	2	0	1	0	0	0	0	3
OG0008265	3	0	0	0	0	0	0	3
OG0008266	3	0	0	0	0	0	0	3
OG0008267	3	0	0	0	0	0	0	3
OG0008268	3	0	0	0	0	0	0	3
OG0008269	3	0	0	0	0	0	0	3
OG0008270	3	0	0	0	0	0	0	3
OG0008271	3	0	0	0	0	0	0	3
OG0008272	3	0	0	0	0	0	0	3
OG0008273	3	0	0	0	0	0	0	3
OG0008274	3	0	0	0	0	0	0	3
OG0008275	2	0	1	0	0	0	0	3
OG0008276	3	0	0	0	0	0	0	3
OG0008277	2	0	1	0	0	0	0	3
OG0008278	3	0	0	0	0	0	0	3
OG0008279	3	0	0	0	0	0	0	3
OG0008280	3	0	0	0	0	0	0	3
OG0008281	3	0	0	0	0	0	0	3
OG0008282	2	0	0	0	0	1	0	3
OG0008283	2	1	0	0	0	0	0	3
OG0008284	2	0	0	0	0	0	1	3
OG0008285	3	0	0	0	0	0	0	3
OG0008286	3	0	0	0	0	0	0	3
OG0008287	2	1	0	0	0	0	0	3
OG0008288	2	0	0	0	0	1	0	3
OG0008289	1	0	1	1	0	0	0	3
OG0008290	3	0	0	0	0	0	0	3
OG0008291	3	0	0	0	0	0	0	3
OG0008292	3	0	0	0	0	0	0	3
OG0008293	2	0	1	0	0	0	0	3
OG0008294	2	0	1	0	0	0	0	3
OG0008295	2	0	1	0	0	0	0	3
OG0008296	2	1	0	0	0	0	0	3
OG0008297	3	0	0	0	0	0	0	3
OG0008298	3	0	0	0	0	0	0	3
OG0008299	2	0	0	1	0	0	0	3
OG0008300	3	0	0	0	0	0	0	3
OG0008301	3	0	0	0	0	0	0	3
OG0008302	3	0	0	0	0	0	0	3
OG0008303	2	0	1	0	0	0	0	3
OG0008304	3	0	0	0	0	0	0	3
OG0008305	1	0	1	0	0	1	0	3
OG0008306	2	0	0	1	0	0	0	3
OG0008307	3	0	0	0	0	0	0	3
OG0008308	2	0	1	0	0	0	0	3
OG0008309	3	0	0	0	0	0	0	3
OG0008310	3	0	0	0	0	0	0	3
OG0008311	3	0	0	0	0	0	0	3
OG0008312	1	1	1	0	0	0	0	3
OG0008313	3	0	0	0	0	0	0	3
OG0008314	3	0	0	0	0	0	0	3
OG0008315	1	1	0	1	0	0	0	3
OG0008316	3	0	0	0	0	0	0	3
OG0008317	3	0	0	0	0	0	0	3
OG0008318	3	0	0	0	0	0	0	3
OG0008319	1	0	1	1	0	0	0	3
OG0008320	1	0	1	0	0	1	0	3
OG0008321	1	0	1	1	0	0	0	3
OG0008322	2	0	1	0	0	0	0	3
OG0008323	3	0	0	0	0	0	0	3
OG0008324	2	0	0	0	0	0	1	3
OG0008325	3	0	0	0	0	0	0	3
OG0008326	3	0	0	0	0	0	0	3
OG0008327	3	0	0	0	0	0	0	3
OG0008328	3	0	0	0	0	0	0	3
OG0008329	1	0	1	1	0	0	0	3
OG0008330	3	0	0	0	0	0	0	3
OG0008331	1	1	0	1	0	0	0	3
OG0008332	3	0	0	0	0	0	0	3
OG0008333	2	0	0	1	0	0	0	3
OG0008334	3	0	0	0	0	0	0	3
OG0008335	2	0	1	0	0	0	0	3
OG0008336	3	0	0	0	0	0	0	3
OG0008337	3	0	0	0	0	0	0	3
OG0008338	2	0	1	0	0	0	0	3
OG0008339	2	0	1	0	0	0	0	3
OG0008340	3	0	0	0	0	0	0	3
OG0008341	3	0	0	0	0	0	0	3
OG0008342	2	0	0	1	0	0	0	3
OG0008343	1	0	1	1	0	0	0	3
OG0008344	3	0	0	0	0	0	0	3
OG0008345	2	1	0	0	0	0	0	3
OG0008346	2	0	0	0	0	1	0	3
OG0008347	2	0	1	0	0	0	0	3
OG0008348	2	0	1	0	0	0	0	3
OG0008349	3	0	0	0	0	0	0	3
OG0008350	3	0	0	0	0	0	0	3
OG0008351	3	0	0	0	0	0	0	3
OG0008352	3	0	0	0	0	0	0	3
OG0008353	3	0	0	0	0	0	0	3
OG0008354	3	0	0	0	0	0	0	3
OG0008355	3	0	0	0	0	0	0	3
OG0008356	3	0	0	0	0	0	0	3
OG0008357	2	0	0	1	0	0	0	3
OG0008358	3	0	0	0	0	0	0	3
OG0008359	3	0	0	0	0	0	0	3
OG0008360	2	0	0	0	0	1	0	3
OG0008361	3	0	0	0	0	0	0	3
OG0008362	3	0	0	0	0	0	0	3
OG0008363	2	0	1	0	0	0	0	3
OG0008364	2	0	0	0	0	1	0	3
OG0008365	1	1	1	0	0	0	0	3
OG0008366	1	0	0	2	0	0	0	3
OG0008367	1	0	0	2	0	0	0	3
OG0008368	3	0	0	0	0	0	0	3
OG0008369	3	0	0	0	0	0	0	3
OG0008370	1	2	0	0	0	0	0	3
OG0008371	2	0	0	1	0	0	0	3
OG0008372	3	0	0	0	0	0	0	3
OG0008373	3	0	0	0	0	0	0	3
OG0008374	3	0	0	0	0	0	0	3
OG0008375	3	0	0	0	0	0	0	3
OG0008376	3	0	0	0	0	0	0	3
OG0008377	3	0	0	0	0	0	0	3
OG0008378	3	0	0	0	0	0	0	3
OG0008379	3	0	0	0	0	0	0	3
OG0008380	2	0	1	0	0	0	0	3
OG0008381	2	0	0	1	0	0	0	3
OG0008382	3	0	0	0	0	0	0	3
OG0008383	2	0	1	0	0	0	0	3
OG0008384	2	0	0	1	0	0	0	3
OG0008385	2	0	1	0	0	0	0	3
OG0008386	1	1	1	0	0	0	0	3
OG0008387	3	0	0	0	0	0	0	3
OG0008388	3	0	0	0	0	0	0	3
OG0008389	2	0	0	0	0	1	0	3
OG0008390	2	0	1	0	0	0	0	3
OG0008391	2	0	0	1	0	0	0	3
OG0008392	2	0	1	0	0	0	0	3
OG0008393	2	0	1	0	0	0	0	3
OG0008394	2	0	1	0	0	0	0	3
OG0008395	2	0	1	0	0	0	0	3
OG0008396	2	0	1	0	0	0	0	3
OG0008397	2	0	1	0	0	0	0	3
OG0008398	3	0	0	0	0	0	0	3
OG0008399	3	0	0	0	0	0	0	3
OG0008400	1	1	1	0	0	0	0	3
OG0008401	2	0	0	0	0	1	0	3
OG0008402	3	0	0	0	0	0	0	3
OG0008403	3	0	0	0	0	0	0	3
OG0008404	3	0	0	0	0	0	0	3
OG0008405	2	0	1	0	0	0	0	3
OG0008406	2	0	0	1	0	0	0	3
OG0008407	2	1	0	0	0	0	0	3
OG0008408	2	0	0	0	0	1	0	3
OG0008409	2	0	0	0	0	1	0	3
OG0008410	2	1	0	0	0	0	0	3
OG0008411	3	0	0	0	0	0	0	3
OG0008412	3	0	0	0	0	0	0	3
OG0008413	3	0	0	0	0	0	0	3
OG0008414	2	1	0	0	0	0	0	3
OG0008415	3	0	0	0	0	0	0	3
OG0008416	3	0	0	0	0	0	0	3
OG0008417	3	0	0	0	0	0	0	3
OG0008418	2	0	0	1	0	0	0	3
OG0008419	2	0	1	0	0	0	0	3
OG0008420	1	1	1	0	0	0	0	3
OG0008421	3	0	0	0	0	0	0	3
OG0008422	1	0	1	1	0	0	0	3
OG0008423	3	0	0	0	0	0	0	3
OG0008424	2	0	1	0	0	0	0	3
OG0008425	3	0	0	0	0	0	0	3
OG0008426	2	0	1	0	0	0	0	3
OG0008427	3	0	0	0	0	0	0	3
OG0008428	2	0	1	0	0	0	0	3
OG0008429	3	0	0	0	0	0	0	3
OG0008430	3	0	0	0	0	0	0	3
OG0008431	3	0	0	0	0	0	0	3
OG0008432	3	0	0	0	0	0	0	3
OG0008433	3	0	0	0	0	0	0	3
OG0008434	2	1	0	0	0	0	0	3
OG0008435	3	0	0	0	0	0	0	3
OG0008436	1	0	2	0	0	0	0	3
OG0008437	1	1	0	1	0	0	0	3
OG0008438	3	0	0	0	0	0	0	3
OG0008439	2	0	0	0	0	1	0	3
OG0008440	2	0	0	0	0	1	0	3
OG0008441	3	0	0	0	0	0	0	3
OG0008442	3	0	0	0	0	0	0	3
OG0008443	2	0	0	1	0	0	0	3
OG0008444	3	0	0	0	0	0	0	3
OG0008445	2	0	1	0	0	0	0	3
OG0008446	1	0	1	1	0	0	0	3
OG0008447	2	0	1	0	0	0	0	3
OG0008448	3	0	0	0	0	0	0	3
OG0008449	1	0	1	1	0	0	0	3
OG0008450	2	0	1	0	0	0	0	3
OG0008451	1	0	1	1	0	0	0	3
OG0008452	3	0	0	0	0	0	0	3
OG0008453	3	0	0	0	0	0	0	3
OG0008454	2	0	1	0	0	0	0	3
OG0008455	3	0	0	0	0	0	0	3
OG0008456	2	0	0	0	0	1	0	3
OG0008457	2	0	0	0	0	1	0	3
OG0008458	3	0	0	0	0	0	0	3
OG0008459	3	0	0	0	0	0	0	3
OG0008460	1	0	1	1	0	0	0	3
OG0008461	3	0	0	0	0	0	0	3
OG0008462	2	0	0	0	0	1	0	3
OG0008463	2	0	1	0	0	0	0	3
OG0008464	3	0	0	0	0	0	0	3
OG0008465	3	0	0	0	0	0	0	3
OG0008466	2	0	1	0	0	0	0	3
OG0008467	2	0	1	0	0	0	0	3
OG0008468	2	0	1	0	0	0	0	3
OG0008469	3	0	0	0	0	0	0	3
OG0008470	1	0	1	1	0	0	0	3
OG0008471	3	0	0	0	0	0	0	3
OG0008472	2	0	1	0	0	0	0	3
OG0008473	2	0	1	0	0	0	0	3
OG0008474	3	0	0	0	0	0	0	3
OG0008475	3	0	0	0	0	0	0	3
OG0008476	2	0	0	1	0	0	0	3
OG0008477	2	0	1	0	0	0	0	3
OG0008478	3	0	0	0	0	0	0	3
OG0008479	3	0	0	0	0	0	0	3
OG0008480	2	0	1	0	0	0	0	3
OG0008481	3	0	0	0	0	0	0	3
OG0008482	2	1	0	0	0	0	0	3
OG0008483	2	0	1	0	0	0	0	3
OG0008484	2	0	0	1	0	0	0	3
OG0008485	3	0	0	0	0	0	0	3
OG0008486	3	0	0	0	0	0	0	3
OG0008487	3	0	0	0	0	0	0	3
OG0008488	3	0	0	0	0	0	0	3
OG0008489	2	0	1	0	0	0	0	3
OG0008490	3	0	0	0	0	0	0	3
OG0008491	3	0	0	0	0	0	0	3
OG0008492	2	0	1	0	0	0	0	3
OG0008493	1	0	1	1	0	0	0	3
OG0008494	1	0	0	2	0	0	0	3
OG0008495	3	0	0	0	0	0	0	3
OG0008496	3	0	0	0	0	0	0	3
OG0008497	2	0	0	0	0	1	0	3
OG0008498	3	0	0	0	0	0	0	3
OG0008499	2	0	1	0	0	0	0	3
OG0008500	1	1	0	1	0	0	0	3
OG0008501	2	0	1	0	0	0	0	3
OG0008502	2	1	0	0	0	0	0	3
OG0008503	2	0	1	0	0	0	0	3
OG0008504	3	0	0	0	0	0	0	3
OG0008505	1	0	1	0	0	1	0	3
OG0008506	1	0	1	1	0	0	0	3
OG0008507	2	0	0	1	0	0	0	3
OG0008508	3	0	0	0	0	0	0	3
OG0008509	1	1	1	0	0	0	0	3
OG0008510	3	0	0	0	0	0	0	3
OG0008511	2	0	1	0	0	0	0	3
OG0008512	3	0	0	0	0	0	0	3
OG0008513	1	0	1	1	0	0	0	3
OG0008514	3	0	0	0	0	0	0	3
OG0008515	1	1	1	0	0	0	0	3
OG0008516	1	0	1	1	0	0	0	3
OG0008517	3	0	0	0	0	0	0	3
OG0008518	1	1	1	0	0	0	0	3
OG0008519	3	0	0	0	0	0	0	3
OG0008520	3	0	0	0	0	0	0	3
OG0008521	3	0	0	0	0	0	0	3
OG0008522	1	0	1	1	0	0	0	3
OG0008523	2	0	0	0	0	1	0	3
OG0008524	2	0	1	0	0	0	0	3
OG0008525	1	0	0	2	0	0	0	3
OG0008526	1	0	1	1	0	0	0	3
OG0008527	1	1	1	0	0	0	0	3
OG0008528	1	0	0	1	0	1	0	3
OG0008529	1	0	2	0	0	0	0	3
OG0008530	3	0	0	0	0	0	0	3
OG0008531	3	0	0	0	0	0	0	3
OG0008532	3	0	0	0	0	0	0	3
OG0008533	3	0	0	0	0	0	0	3
OG0008534	2	0	1	0	0	0	0	3
OG0008535	2	0	0	1	0	0	0	3
OG0008536	3	0	0	0	0	0	0	3
OG0008537	2	0	0	0	0	1	0	3
OG0008538	3	0	0	0	0	0	0	3
OG0008539	2	0	1	0	0	0	0	3
OG0008540	2	0	1	0	0	0	0	3
OG0008541	2	0	1	0	0	0	0	3
OG0008542	3	0	0	0	0	0	0	3
OG0008543	3	0	0	0	0	0	0	3
OG0008544	1	1	0	1	0	0	0	3
OG0008545	2	0	0	0	0	1	0	3
OG0008546	3	0	0	0	0	0	0	3
OG0008547	1	0	1	1	0	0	0	3
OG0008548	2	0	0	0	0	1	0	3
OG0008549	3	0	0	0	0	0	0	3
OG0008550	1	0	1	1	0	0	0	3
OG0008551	2	0	1	0	0	0	0	3
OG0008552	3	0	0	0	0	0	0	3
OG0008553	3	0	0	0	0	0	0	3
OG0008554	3	0	0	0	0	0	0	3
OG0008555	2	0	1	0	0	0	0	3
OG0008556	2	0	0	0	0	0	1	3
OG0008557	3	0	0	0	0	0	0	3
OG0008558	2	0	1	0	0	0	0	3
OG0008559	3	0	0	0	0	0	0	3
OG0008560	3	0	0	0	0	0	0	3
OG0008561	1	0	0	0	0	1	1	3
OG0008562	1	1	0	0	0	1	0	3
OG0008563	3	0	0	0	0	0	0	3
OG0008564	1	1	1	0	0	0	0	3
OG0008565	3	0	0	0	0	0	0	3
OG0008566	3	0	0	0	0	0	0	3
OG0008567	2	0	1	0	0	0	0	3
OG0008568	3	0	0	0	0	0	0	3
OG0008569	1	1	0	1	0	0	0	3
OG0008570	3	0	0	0	0	0	0	3
OG0008571	2	0	0	1	0	0	0	3
OG0008572	3	0	0	0	0	0	0	3
OG0008573	3	0	0	0	0	0	0	3
OG0008574	3	0	0	0	0	0	0	3
OG0008575	1	1	0	1	0	0	0	3
OG0008576	1	0	1	1	0	0	0	3
OG0008577	2	0	0	1	0	0	0	3
OG0008578	1	0	2	0	0	0	0	3
OG0008579	2	0	0	1	0	0	0	3
OG0008580	1	1	0	0	1	0	0	3
OG0008581	0	1	1	1	0	0	0	3
OG0008582	0	3	0	0	0	0	0	3
OG0008583	0	1	1	1	0	0	0	3
OG0008584	0	3	0	0	0	0	0	3
OG0008585	0	1	1	1	0	0	0	3
OG0008586	0	1	1	1	0	0	0	3
OG0008587	0	1	0	0	0	2	0	3
OG0008588	0	1	0	1	0	1	0	3
OG0008589	0	1	2	0	0	0	0	3
OG0008590	0	1	0	2	0	0	0	3
OG0008591	0	3	0	0	0	0	0	3
OG0008592	0	1	1	1	0	0	0	3
OG0008593	0	3	0	0	0	0	0	3
OG0008594	0	3	0	0	0	0	0	3
OG0008595	0	1	1	1	0	0	0	3
OG0008596	0	1	0	0	0	0	2	3
OG0008597	0	1	1	1	0	0	0	3
OG0008598	0	1	1	1	0	0	0	3
OG0008599	0	3	0	0	0	0	0	3
OG0008600	0	1	1	1	0	0	0	3
OG0008601	0	1	1	1	0	0	0	3
OG0008602	0	1	2	0	0	0	0	3
OG0008603	0	1	1	0	0	1	0	3
OG0008604	0	1	1	1	0	0	0	3
OG0008605	0	1	1	1	0	0	0	3
OG0008606	0	1	1	1	0	0	0	3
OG0008607	0	1	1	1	0	0	0	3
OG0008608	0	1	1	1	0	0	0	3
OG0008609	0	1	1	1	0	0	0	3
OG0008610	0	1	0	2	0	0	0	3
OG0008611	0	1	1	1	0	0	0	3
OG0008612	0	3	0	0	0	0	0	3
OG0008613	0	1	2	0	0	0	0	3
OG0008614	0	1	1	1	0	0	0	3
OG0008615	0	1	1	1	0	0	0	3
OG0008616	0	1	0	2	0	0	0	3
OG0008617	0	1	1	1	0	0	0	3
OG0008618	0	2	0	1	0	0	0	3
OG0008619	0	1	0	2	0	0	0	3
OG0008620	0	3	0	0	0	0	0	3
OG0008621	0	3	0	0	0	0	0	3
OG0008622	0	2	0	1	0	0	0	3
OG0008623	0	3	0	0	0	0	0	3
OG0008624	0	1	1	1	0	0	0	3
OG0008625	0	1	1	1	0	0	0	3
OG0008626	0	1	1	1	0	0	0	3
OG0008627	0	1	1	1	0	0	0	3
OG0008628	0	1	1	1	0	0	0	3
OG0008629	0	2	1	0	0	0	0	3
OG0008630	0	1	0	2	0	0	0	3
OG0008631	0	1	1	1	0	0	0	3
OG0008632	0	1	1	1	0	0	0	3
OG0008633	0	1	1	1	0	0	0	3
OG0008634	0	1	1	1	0	0	0	3
OG0008635	0	1	1	1	0	0	0	3
OG0008636	0	3	0	0	0	0	0	3
OG0008637	0	1	0	0	0	2	0	3
OG0008638	0	1	1	1	0	0	0	3
OG0008639	0	2	0	1	0	0	0	3
OG0008640	0	1	1	1	0	0	0	3
OG0008641	0	1	1	1	0	0	0	3
OG0008642	0	1	1	0	0	1	0	3
OG0008643	0	1	1	1	0	0	0	3
OG0008644	0	1	1	1	0	0	0	3
OG0008645	0	3	0	0	0	0	0	3
OG0008646	0	1	1	1	0	0	0	3
OG0008647	0	1	1	1	0	0	0	3
OG0008648	0	1	1	1	0	0	0	3
OG0008649	0	3	0	0	0	0	0	3
OG0008650	0	3	0	0	0	0	0	3
OG0008651	0	1	1	1	0	0	0	3
OG0008652	0	3	0	0	0	0	0	3
OG0008653	0	1	1	1	0	0	0	3
OG0008654	0	1	1	1	0	0	0	3
OG0008655	0	1	1	1	0	0	0	3
OG0008656	0	3	0	0	0	0	0	3
OG0008657	0	1	1	1	0	0	0	3
OG0008658	0	1	0	1	1	0	0	3
OG0008659	0	1	1	1	0	0	0	3
OG0008660	0	1	1	1	0	0	0	3
OG0008661	0	1	1	1	0	0	0	3
OG0008662	0	1	1	1	0	0	0	3
OG0008663	0	1	1	1	0	0	0	3
OG0008664	0	3	0	0	0	0	0	3
OG0008665	0	1	1	1	0	0	0	3
OG0008666	0	1	1	1	0	0	0	3
OG0008667	0	1	0	1	0	1	0	3
OG0008668	0	1	1	1	0	0	0	3
OG0008669	0	1	1	1	0	0	0	3
OG0008670	0	1	1	1	0	0	0	3
OG0008671	0	1	1	1	0	0	0	3
OG0008672	0	1	1	1	0	0	0	3
OG0008673	0	1	1	1	0	0	0	3
OG0008674	0	1	1	1	0	0	0	3
OG0008675	0	1	1	1	0	0	0	3
OG0008676	0	1	1	1	0	0	0	3
OG0008677	0	1	1	1	0	0	0	3
OG0008678	0	1	1	1	0	0	0	3
OG0008679	0	1	1	1	0	0	0	3
OG0008680	0	2	1	0	0	0	0	3
OG0008681	0	1	1	1	0	0	0	3
OG0008682	0	1	1	1	0	0	0	3
OG0008683	0	1	1	1	0	0	0	3
OG0008684	0	1	2	0	0	0	0	3
OG0008685	0	3	0	0	0	0	0	3
OG0008686	0	3	0	0	0	0	0	3
OG0008687	0	3	0	0	0	0	0	3
OG0008688	0	1	0	2	0	0	0	3
OG0008689	0	1	1	1	0	0	0	3
OG0008690	0	1	1	1	0	0	0	3
OG0008691	0	1	1	1	0	0	0	3
OG0008692	0	1	1	1	0	0	0	3
OG0008693	0	1	1	1	0	0	0	3
OG0008694	0	1	1	1	0	0	0	3
OG0008695	0	1	1	1	0	0	0	3
OG0008696	0	1	1	1	0	0	0	3
OG0008697	0	1	1	1	0	0	0	3
OG0008698	0	1	1	1	0	0	0	3
OG0008699	0	1	1	1	0	0	0	3
OG0008700	0	1	1	1	0	0	0	3
OG0008701	0	1	1	1	0	0	0	3
OG0008702	0	1	1	1	0	0	0	3
OG0008703	0	1	0	2	0	0	0	3
OG0008704	0	1	1	1	0	0	0	3
OG0008705	0	1	1	1	0	0	0	3
OG0008706	0	0	3	0	0	0	0	3
OG0008707	0	0	3	0	0	0	0	3
OG0008708	0	0	1	0	0	2	0	3
OG0008709	0	0	3	0	0	0	0	3
OG0008710	0	0	3	0	0	0	0	3
OG0008711	0	0	2	1	0	0	0	3
OG0008712	0	0	1	1	0	1	0	3
OG0008713	0	0	3	0	0	0	0	3
OG0008714	0	0	1	1	0	1	0	3
OG0008715	0	0	3	0	0	0	0	3
OG0008716	0	0	1	0	0	0	2	3
OG0008717	0	0	3	0	0	0	0	3
OG0008718	0	0	2	1	0	0	0	3
OG0008719	0	0	1	2	0	0	0	3
OG0008720	0	0	1	0	0	0	2	3
OG0008721	0	0	3	0	0	0	0	3
OG0008722	0	0	2	1	0	0	0	3
OG0008723	0	0	3	0	0	0	0	3
OG0008724	0	0	3	0	0	0	0	3
OG0008725	0	0	1	0	0	2	0	3
OG0008726	0	0	1	1	0	1	0	3
OG0008727	0	0	2	1	0	0	0	3
OG0008728	0	0	2	1	0	0	0	3
OG0008729	0	0	3	0	0	0	0	3
OG0008730	0	0	2	1	0	0	0	3
OG0008731	0	0	3	0	0	0	0	3
OG0008732	0	0	3	0	0	0	0	3
OG0008733	0	0	3	0	0	0	0	3
OG0008734	0	0	3	0	0	0	0	3
OG0008735	0	0	3	0	0	0	0	3
OG0008736	0	0	3	0	0	0	0	3
OG0008737	0	0	3	0	0	0	0	3
OG0008738	0	0	1	1	0	1	0	3
OG0008739	0	0	3	0	0	0	0	3
OG0008740	0	0	1	0	2	0	0	3
OG0008741	0	0	3	0	0	0	0	3
OG0008742	0	0	3	0	0	0	0	3
OG0008743	0	0	1	2	0	0	0	3
OG0008744	0	0	2	1	0	0	0	3
OG0008745	0	0	2	1	0	0	0	3
OG0008746	0	0	3	0	0	0	0	3
OG0008747	0	0	1	0	0	2	0	3
OG0008748	0	0	3	0	0	0	0	3
OG0008749	0	0	1	2	0	0	0	3
OG0008750	0	0	1	2	0	0	0	3
OG0008751	0	0	3	0	0	0	0	3
OG0008752	0	0	3	0	0	0	0	3
OG0008753	0	0	3	0	0	0	0	3
OG0008754	0	0	3	0	0	0	0	3
OG0008755	0	0	1	0	1	0	1	3
OG0008756	0	0	3	0	0	0	0	3
OG0008757	0	0	3	0	0	0	0	3
OG0008758	0	0	3	0	0	0	0	3
OG0008759	0	0	3	0	0	0	0	3
OG0008760	0	0	2	1	0	0	0	3
OG0008761	0	0	1	2	0	0	0	3
OG0008762	0	0	3	0	0	0	0	3
OG0008763	0	0	1	2	0	0	0	3
OG0008764	0	0	3	0	0	0	0	3
OG0008765	0	0	2	0	0	1	0	3
OG0008766	0	0	3	0	0	0	0	3
OG0008767	0	0	3	0	0	0	0	3
OG0008768	0	0	2	1	0	0	0	3
OG0008769	0	0	3	0	0	0	0	3
OG0008770	0	0	3	0	0	0	0	3
OG0008771	0	0	3	0	0	0	0	3
OG0008772	0	0	3	0	0	0	0	3
OG0008773	0	0	2	1	0	0	0	3
OG0008774	0	0	3	0	0	0	0	3
OG0008775	0	0	3	0	0	0	0	3
OG0008776	0	0	3	0	0	0	0	3
OG0008777	0	0	3	0	0	0	0	3
OG0008778	0	0	1	2	0	0	0	3
OG0008779	0	0	2	1	0	0	0	3
OG0008780	0	0	1	1	0	1	0	3
OG0008781	0	0	1	2	0	0	0	3
OG0008782	0	0	3	0	0	0	0	3
OG0008783	0	0	0	3	0	0	0	3
OG0008784	0	0	0	3	0	0	0	3
OG0008785	0	0	0	3	0	0	0	3
OG0008786	0	0	0	3	0	0	0	3
OG0008787	0	0	0	3	0	0	0	3
OG0008788	0	0	0	3	0	0	0	3
OG0008789	0	0	0	2	0	1	0	3
OG0008790	0	0	0	3	0	0	0	3
OG0008791	0	0	0	3	0	0	0	3
OG0008792	0	0	0	3	0	0	0	3
OG0008793	0	0	0	3	0	0	0	3
OG0008794	0	0	0	3	0	0	0	3
OG0008795	0	0	0	3	0	0	0	3
OG0008796	0	0	0	3	0	0	0	3
OG0008797	0	0	0	3	0	0	0	3
OG0008798	0	0	0	3	0	0	0	3
OG0008799	0	0	0	3	0	0	0	3
OG0008800	0	0	0	3	0	0	0	3
OG0008801	0	0	0	3	0	0	0	3
OG0008802	0	0	0	3	0	0	0	3
OG0008803	0	0	0	3	0	0	0	3
OG0008804	0	0	0	3	0	0	0	3
OG0008805	0	0	0	3	0	0	0	3
OG0008806	0	0	0	3	0	0	0	3
OG0008807	0	0	0	3	0	0	0	3
OG0008808	0	0	0	3	0	0	0	3
OG0008809	0	0	0	3	0	0	0	3
OG0008810	0	0	0	3	0	0	0	3
OG0008811	0	0	0	3	0	0	0	3
OG0008812	0	0	0	3	0	0	0	3
OG0008813	0	0	0	3	0	0	0	3
OG0008814	0	0	0	3	0	0	0	3
OG0008815	0	0	0	3	0	0	0	3
OG0008816	0	0	0	3	0	0	0	3
OG0008817	0	0	0	3	0	0	0	3
OG0008818	0	0	0	3	0	0	0	3
OG0008819	0	0	0	3	0	0	0	3
OG0008820	0	0	0	3	0	0	0	3
OG0008821	0	0	0	3	0	0	0	3
OG0008822	0	0	0	3	0	0	0	3
OG0008823	0	0	0	3	0	0	0	3
OG0008824	0	0	0	3	0	0	0	3
OG0008825	0	0	0	3	0	0	0	3
OG0008826	0	0	0	3	0	0	0	3
OG0008827	0	0	0	3	0	0	0	3
OG0008828	0	0	0	3	0	0	0	3
OG0008829	0	0	0	3	0	0	0	3
OG0008830	0	0	0	3	0	0	0	3
OG0008831	0	0	0	3	0	0	0	3
OG0008832	0	0	0	3	0	0	0	3
OG0008833	0	0	0	3	0	0	0	3
OG0008834	0	0	0	3	0	0	0	3
OG0008835	0	0	0	3	0	0	0	3
OG0008836	0	0	0	3	0	0	0	3
OG0008837	0	0	0	3	0	0	0	3
OG0008838	0	0	0	3	0	0	0	3
OG0008839	0	0	0	3	0	0	0	3
OG0008840	0	0	0	3	0	0	0	3
OG0008841	0	0	0	3	0	0	0	3
OG0008842	0	0	0	3	0	0	0	3
OG0008843	0	0	0	3	0	0	0	3
OG0008844	0	0	0	3	0	0	0	3
OG0008845	0	0	0	3	0	0	0	3
OG0008846	0	0	0	3	0	0	0	3
OG0008847	0	0	0	3	0	0	0	3
OG0008848	0	0	0	3	0	0	0	3
OG0008849	0	0	0	3	0	0	0	3
OG0008850	0	0	0	3	0	0	0	3
OG0008851	0	0	0	3	0	0	0	3
OG0008852	0	0	0	3	0	0	0	3
OG0008853	0	0	0	3	0	0	0	3
OG0008854	0	0	0	3	0	0	0	3
OG0008855	0	0	0	3	0	0	0	3
OG0008856	0	0	0	3	0	0	0	3
OG0008857	0	0	0	3	0	0	0	3
OG0008858	0	0	0	3	0	0	0	3
OG0008859	0	0	0	3	0	0	0	3
OG0008860	0	0	0	3	0	0	0	3
OG0008861	0	0	0	3	0	0	0	3
OG0008862	0	0	0	3	0	0	0	3
OG0008863	0	0	0	3	0	0	0	3
OG0008864	0	0	0	3	0	0	0	3
OG0008865	0	0	0	3	0	0	0	3
OG0008866	0	0	0	3	0	0	0	3
OG0008867	0	0	0	3	0	0	0	3
OG0008868	0	0	0	3	0	0	0	3
OG0008869	0	0	0	3	0	0	0	3
OG0008870	0	0	0	3	0	0	0	3
OG0008871	0	0	0	3	0	0	0	3
OG0008872	0	0	0	3	0	0	0	3
OG0008873	0	0	0	3	0	0	0	3
OG0008874	0	0	0	3	0	0	0	3
OG0008875	0	0	0	3	0	0	0	3
OG0008876	0	0	0	3	0	0	0	3
OG0008877	0	0	0	3	0	0	0	3
OG0008878	0	0	0	3	0	0	0	3
OG0008879	0	0	0	3	0	0	0	3
OG0008880	0	0	0	3	0	0	0	3
OG0008881	0	0	0	1	0	1	1	3
OG0008882	0	0	0	3	0	0	0	3
OG0008883	0	0	0	1	0	0	2	3
OG0008884	0	0	0	3	0	0	0	3
OG0008885	0	0	0	3	0	0	0	3
OG0008886	0	0	0	3	0	0	0	3
OG0008887	0	0	0	1	0	2	0	3
OG0008888	0	0	0	3	0	0	0	3
OG0008889	0	0	0	3	0	0	0	3
OG0008890	0	0	0	3	0	0	0	3
OG0008891	0	0	0	2	0	1	0	3
OG0008892	0	0	0	3	0	0	0	3
OG0008893	0	0	0	3	0	0	0	3
OG0008894	0	0	0	2	0	1	0	3
OG0008895	0	0	0	1	2	0	0	3
OG0008896	0	0	0	0	2	0	1	3
OG0008897	0	0	0	0	3	0	0	3
OG0008898	0	0	0	0	3	0	0	3
OG0008899	0	0	0	0	1	1	1	3
OG0008900	0	0	0	0	3	0	0	3
OG0008901	0	0	0	0	2	0	1	3
OG0008902	0	0	0	0	3	0	0	3
OG0008903	0	0	0	0	2	0	1	3
OG0008904	0	0	0	0	2	0	1	3
OG0008905	0	0	0	0	2	0	1	3
OG0008906	0	0	0	0	2	0	1	3
OG0008907	0	0	0	0	2	0	1	3
OG0008908	0	0	0	0	2	0	1	3
OG0008909	0	0	0	0	3	0	0	3
OG0008910	0	0	0	0	2	0	1	3
OG0008911	0	0	0	0	2	0	1	3
OG0008912	0	0	0	0	2	0	1	3
OG0008913	0	0	0	0	2	0	1	3
OG0008914	0	0	0	0	1	0	2	3
OG0008915	0	0	0	0	2	0	1	3
OG0008916	0	0	0	0	2	0	1	3
OG0008917	0	0	0	0	1	0	2	3
OG0008918	0	0	0	0	3	0	0	3
OG0008919	0	0	0	0	1	0	2	3
OG0008920	0	0	0	0	3	0	0	3
OG0008921	0	0	0	0	1	0	2	3
OG0008922	0	0	0	0	2	0	1	3
OG0008923	0	0	0	0	2	0	1	3
OG0008924	0	0	0	0	3	0	0	3
OG0008925	0	0	0	0	2	0	1	3
OG0008926	0	0	0	0	3	0	0	3
OG0008927	0	0	0	0	2	0	1	3
OG0008928	0	0	0	0	2	0	1	3
OG0008929	0	0	0	0	2	0	1	3
OG0008930	0	0	0	0	3	0	0	3
OG0008931	0	0	0	0	2	0	1	3
OG0008932	0	0	0	0	2	0	1	3
OG0008933	0	0	0	0	3	0	0	3
OG0008934	0	0	0	0	3	0	0	3
OG0008935	0	0	0	0	3	0	0	3
OG0008936	0	0	0	0	3	0	0	3
OG0008937	0	0	0	0	2	0	1	3
OG0008938	0	0	0	0	1	1	1	3
OG0008939	0	0	0	0	2	0	1	3
OG0008940	0	0	0	0	3	0	0	3
OG0008941	0	0	0	0	2	0	1	3
OG0008942	0	0	0	0	2	0	1	3
OG0008943	0	0	0	0	1	0	2	3
OG0008944	0	0	0	0	3	0	0	3
OG0008945	0	0	0	0	3	0	0	3
OG0008946	0	0	0	0	3	0	0	3
OG0008947	0	0	0	0	2	0	1	3
OG0008948	0	0	0	0	2	0	1	3
OG0008949	0	0	0	0	3	0	0	3
OG0008950	0	0	0	0	3	0	0	3
OG0008951	0	0	0	0	2	0	1	3
OG0008952	0	0	0	0	2	0	1	3
OG0008953	0	0	0	0	2	0	1	3
OG0008954	0	0	0	0	2	0	1	3
OG0008955	0	0	0	0	2	0	1	3
OG0008956	0	0	0	0	2	0	1	3
OG0008957	0	0	0	0	2	0	1	3
OG0008958	0	0	0	0	2	1	0	3
OG0008959	0	0	0	0	2	0	1	3
OG0008960	0	0	0	0	2	0	1	3
OG0008961	0	0	0	0	2	0	1	3
OG0008962	0	0	0	0	3	0	0	3
OG0008963	0	0	0	0	3	0	0	3
OG0008964	0	0	0	0	3	0	0	3
OG0008965	0	0	0	0	2	0	1	3
OG0008966	0	0	0	0	2	0	1	3
OG0008967	0	0	0	0	1	0	2	3
OG0008968	0	0	0	0	1	0	2	3
OG0008969	0	0	0	0	2	0	1	3
OG0008970	0	0	0	0	1	0	2	3
OG0008971	0	0	0	0	2	0	1	3
OG0008972	0	0	0	0	2	0	1	3
OG0008973	0	0	0	0	2	0	1	3
OG0008974	0	0	0	0	3	0	0	3
OG0008975	0	0	0	0	2	0	1	3
OG0008976	0	0	0	0	2	0	1	3
OG0008977	0	0	0	0	2	0	1	3
OG0008978	0	0	0	0	2	0	1	3
OG0008979	0	0	0	0	2	0	1	3
OG0008980	0	0	0	0	1	1	1	3
OG0008981	0	0	0	0	2	0	1	3
OG0008982	0	0	0	0	2	0	1	3
OG0008983	0	0	0	0	2	0	1	3
OG0008984	0	0	0	0	2	0	1	3
OG0008985	0	0	0	0	2	0	1	3
OG0008986	0	0	0	0	3	0	0	3
OG0008987	0	0	0	0	1	0	2	3
OG0008988	0	0	0	0	1	1	1	3
OG0008989	0	0	0	0	2	0	1	3
OG0008990	0	0	0	0	2	0	1	3
OG0008991	0	0	0	0	3	0	0	3
OG0008992	0	0	0	0	3	0	0	3
OG0008993	0	0	0	0	3	0	0	3
OG0008994	0	0	0	0	2	0	1	3
OG0008995	0	0	0	0	2	0	1	3
OG0008996	0	0	0	0	3	0	0	3
OG0008997	0	0	0	0	2	0	1	3
OG0008998	0	0	0	0	2	0	1	3
OG0008999	0	0	0	0	2	0	1	3
OG0009000	0	0	0	0	2	0	1	3
OG0009001	0	0	0	0	2	0	1	3
OG0009002	0	0	0	0	2	0	1	3
OG0009003	0	0	0	0	2	0	1	3
OG0009004	0	0	0	0	2	0	1	3
OG0009005	0	0	0	0	2	0	1	3
OG0009006	0	0	0	0	2	0	1	3
OG0009007	0	0	0	0	3	0	0	3
OG0009008	0	0	0	0	3	0	0	3
OG0009009	0	0	0	0	2	0	1	3
OG0009010	0	0	0	0	2	0	1	3
OG0009011	0	0	0	0	2	0	1	3
OG0009012	0	0	0	0	1	0	2	3
OG0009013	0	0	0	0	1	0	2	3
OG0009014	0	0	0	0	3	0	0	3
OG0009015	0	0	0	0	3	0	0	3
OG0009016	0	0	0	0	2	0	1	3
OG0009017	0	0	0	0	2	0	1	3
OG0009018	0	0	0	0	2	0	1	3
OG0009019	0	0	0	0	2	0	1	3
OG0009020	0	0	0	0	2	0	1	3
OG0009021	0	0	0	0	3	0	0	3
OG0009022	0	0	0	0	2	0	1	3
OG0009023	0	0	0	0	2	0	1	3
OG0009024	0	0	0	0	2	0	1	3
OG0009025	0	0	0	0	2	0	1	3
OG0009026	0	0	0	0	2	0	1	3
OG0009027	0	0	0	0	2	0	1	3
OG0009028	0	0	0	0	2	0	1	3
OG0009029	0	0	0	0	2	0	1	3
OG0009030	0	0	0	0	2	0	1	3
OG0009031	0	0	0	0	2	0	1	3
OG0009032	0	0	0	0	1	1	1	3
OG0009033	0	0	0	0	2	0	1	3
OG0009034	0	0	0	0	2	0	1	3
OG0009035	0	0	0	0	1	0	2	3
OG0009036	0	0	0	0	1	0	2	3
OG0009037	0	0	0	0	2	0	1	3
OG0009038	0	0	0	0	2	0	1	3
OG0009039	0	0	0	0	2	0	1	3
OG0009040	0	0	0	0	2	0	1	3
OG0009041	0	0	0	0	3	0	0	3
OG0009042	0	0	0	0	2	0	1	3
OG0009043	0	0	0	0	2	0	1	3
OG0009044	0	0	0	0	1	0	2	3
OG0009045	0	0	0	0	1	0	2	3
OG0009046	0	0	0	0	1	0	2	3
OG0009047	0	0	0	0	3	0	0	3
OG0009048	0	0	0	0	2	0	1	3
OG0009049	0	0	0	0	1	0	2	3
OG0009050	0	0	0	0	2	0	1	3
OG0009051	0	0	0	0	1	1	1	3
OG0009052	0	0	0	0	2	0	1	3
OG0009053	0	0	0	0	2	0	1	3
OG0009054	0	0	0	0	2	0	1	3
OG0009055	0	0	0	0	2	0	1	3
OG0009056	0	0	0	0	2	0	1	3
OG0009057	0	0	0	0	1	1	1	3
OG0009058	0	0	0	0	2	0	1	3
OG0009059	0	0	0	0	1	1	1	3
OG0009060	0	0	0	0	2	0	1	3
OG0009061	0	0	0	0	1	0	2	3
OG0009062	0	0	0	0	2	0	1	3
OG0009063	0	0	0	0	1	0	2	3
OG0009064	0	0	0	0	2	0	1	3
OG0009065	0	0	0	0	2	0	1	3
OG0009066	0	0	0	0	3	0	0	3
OG0009067	0	0	0	0	2	0	1	3
OG0009068	0	0	0	0	2	0	1	3
OG0009069	0	0	0	0	1	1	1	3
OG0009070	0	0	0	0	1	0	2	3
OG0009071	0	0	0	0	2	0	1	3
OG0009072	0	0	0	0	2	0	1	3
OG0009073	0	0	0	0	1	0	2	3
OG0009074	0	0	0	0	2	0	1	3
OG0009075	0	0	0	0	1	1	1	3
OG0009076	0	0	0	0	3	0	0	3
OG0009077	0	0	0	0	2	0	1	3
OG0009078	0	0	0	0	2	0	1	3
OG0009079	0	0	0	0	1	1	1	3
OG0009080	0	0	0	0	2	0	1	3
OG0009081	0	0	0	0	2	0	1	3
OG0009082	0	0	0	0	2	0	1	3
OG0009083	0	0	0	0	3	0	0	3
OG0009084	0	0	0	0	2	0	1	3
OG0009085	0	0	0	0	2	0	1	3
OG0009086	0	0	0	0	3	0	0	3
OG0009087	0	0	0	0	2	0	1	3
OG0009088	0	0	0	0	2	0	1	3
OG0009089	0	0	0	0	2	0	1	3
OG0009090	0	0	0	0	3	0	0	3
OG0009091	0	0	0	0	2	0	1	3
OG0009092	0	0	0	0	2	0	1	3
OG0009093	0	0	0	0	2	0	1	3
OG0009094	0	0	0	0	3	0	0	3
OG0009095	0	0	0	0	2	0	1	3
OG0009096	0	0	0	0	2	0	1	3
OG0009097	0	0	0	0	1	0	2	3
OG0009098	0	0	0	0	1	0	2	3
OG0009099	0	0	0	0	1	1	1	3
OG0009100	0	0	0	0	2	0	1	3
OG0009101	0	0	0	0	1	1	1	3
OG0009102	0	0	0	0	1	0	2	3
OG0009103	0	0	0	0	1	1	1	3
OG0009104	0	0	0	0	2	0	1	3
OG0009105	0	0	0	0	2	0	1	3
OG0009106	0	0	0	0	1	1	1	3
OG0009107	0	0	0	0	2	0	1	3
OG0009108	0	0	0	0	2	0	1	3
OG0009109	0	0	0	0	2	0	1	3
OG0009110	0	0	0	0	1	1	1	3
OG0009111	0	0	0	0	3	0	0	3
OG0009112	0	0	0	0	2	0	1	3
OG0009113	0	0	0	0	2	0	1	3
OG0009114	0	0	0	0	2	0	1	3
OG0009115	0	0	0	0	1	0	2	3
OG0009116	0	0	0	0	1	0	2	3
OG0009117	0	0	0	0	2	0	1	3
OG0009118	0	0	0	0	2	0	1	3
OG0009119	0	0	0	0	2	0	1	3
OG0009120	0	0	0	0	1	1	1	3
OG0009121	0	0	0	0	1	0	2	3
OG0009122	0	0	0	0	2	0	1	3
OG0009123	0	0	0	0	2	0	1	3
OG0009124	0	0	0	0	1	1	1	3
OG0009125	0	0	0	0	2	0	1	3
OG0009126	0	0	0	0	2	0	1	3
OG0009127	0	0	0	0	2	0	1	3
OG0009128	0	0	0	0	2	0	1	3
OG0009129	0	0	0	0	2	0	1	3
OG0009130	0	0	0	0	2	0	1	3
OG0009131	0	0	0	0	2	0	1	3
OG0009132	0	0	0	0	2	0	1	3
OG0009133	0	0	0	0	2	0	1	3
OG0009134	0	0	0	0	2	0	1	3
OG0009135	0	0	0	0	2	0	1	3
OG0009136	0	0	0	0	2	0	1	3
OG0009137	0	0	0	0	2	0	1	3
OG0009138	0	0	0	0	3	0	0	3
OG0009139	0	0	0	0	2	0	1	3
OG0009140	0	0	0	0	1	1	1	3
OG0009141	0	0	0	0	3	0	0	3
OG0009142	0	0	0	0	1	0	2	3
OG0009143	0	0	0	0	2	0	1	3
OG0009144	0	0	0	0	1	0	2	3
OG0009145	0	0	0	0	3	0	0	3
OG0009146	0	0	0	0	2	0	1	3
OG0009147	0	0	0	0	1	1	1	3
OG0009148	0	0	0	0	1	1	1	3
OG0009149	0	0	0	0	1	0	2	3
OG0009150	0	0	0	0	2	0	1	3
OG0009151	0	0	0	0	1	1	1	3
OG0009152	0	0	0	0	1	0	2	3
OG0009153	0	0	0	0	2	0	1	3
OG0009154	0	0	0	0	2	0	1	3
OG0009155	0	0	0	0	2	0	1	3
OG0009156	0	0	0	0	1	1	1	3
OG0009157	0	0	0	0	2	0	1	3
OG0009158	0	0	0	0	1	0	2	3
OG0009159	0	0	0	0	3	0	0	3
OG0009160	0	0	0	0	3	0	0	3
OG0009161	0	0	0	0	2	0	1	3
OG0009162	0	0	0	0	2	0	1	3
OG0009163	0	0	0	0	2	0	1	3
OG0009164	0	0	0	0	2	0	1	3
OG0009165	0	0	0	0	1	1	1	3
OG0009166	0	0	0	0	3	0	0	3
OG0009167	0	0	0	0	1	1	1	3
OG0009168	0	0	0	0	1	0	2	3
OG0009169	0	0	0	0	1	0	2	3
OG0009170	0	0	0	0	1	1	1	3
OG0009171	0	0	0	0	2	0	1	3
OG0009172	0	0	0	0	2	0	1	3
OG0009173	0	0	0	0	2	0	1	3
OG0009174	0	0	0	0	2	0	1	3
OG0009175	0	0	0	0	1	1	1	3
OG0009176	0	0	0	0	2	0	1	3
OG0009177	0	0	0	0	2	0	1	3
OG0009178	0	0	0	0	1	1	1	3
OG0009179	0	0	0	0	2	0	1	3
OG0009180	0	0	0	0	2	0	1	3
OG0009181	0	0	0	0	2	0	1	3
OG0009182	0	0	0	0	3	0	0	3
OG0009183	0	0	0	0	2	0	1	3
OG0009184	0	0	0	0	2	0	1	3
OG0009185	0	0	0	0	1	0	2	3
OG0009186	0	0	0	0	2	0	1	3
OG0009187	0	0	0	0	1	0	2	3
OG0009188	0	0	0	0	3	0	0	3
OG0009189	0	0	0	0	1	1	1	3
OG0009190	0	0	0	0	2	0	1	3
OG0009191	0	0	0	0	2	0	1	3
OG0009192	0	0	0	0	2	0	1	3
OG0009193	0	0	0	0	1	0	2	3
OG0009194	0	0	0	0	1	1	1	3
OG0009195	0	0	0	0	1	0	2	3
OG0009196	0	0	0	0	3	0	0	3
OG0009197	0	0	0	0	1	1	1	3
OG0009198	0	0	0	0	1	0	2	3
OG0009199	0	0	0	0	2	0	1	3
OG0009200	0	0	0	0	2	0	1	3
OG0009201	0	0	0	0	3	0	0	3
OG0009202	0	0	0	0	2	0	1	3
OG0009203	0	0	0	0	3	0	0	3
OG0009204	0	0	0	0	2	0	1	3
OG0009205	0	0	0	0	1	1	1	3
OG0009206	0	0	0	0	1	0	2	3
OG0009207	0	0	0	0	2	0	1	3
OG0009208	0	0	0	0	1	0	2	3
OG0009209	0	0	0	0	1	0	2	3
OG0009210	0	0	0	0	1	0	2	3
OG0009211	0	0	0	0	2	0	1	3
OG0009212	0	0	0	0	1	0	2	3
OG0009213	0	0	0	0	1	1	1	3
OG0009214	0	0	0	0	2	0	1	3
OG0009215	0	0	0	0	1	0	2	3
OG0009216	0	0	0	0	2	0	1	3
OG0009217	0	0	0	0	2	0	1	3
OG0009218	0	0	0	0	1	1	1	3
OG0009219	0	0	0	0	1	0	2	3
OG0009220	0	0	0	0	1	1	1	3
OG0009221	0	0	0	0	1	0	2	3
OG0009222	0	0	0	0	1	0	2	3
OG0009223	0	0	0	0	1	1	1	3
OG0009224	0	0	0	0	1	1	1	3
OG0009225	0	0	0	0	1	1	1	3
OG0009226	0	0	0	0	2	0	1	3
OG0009227	0	0	0	0	2	0	1	3
OG0009228	0	0	0	0	2	0	1	3
OG0009229	0	0	0	0	3	0	0	3
OG0009230	0	0	0	0	2	0	1	3
OG0009231	0	0	0	0	2	0	1	3
OG0009232	0	0	0	0	2	0	1	3
OG0009233	0	0	0	0	2	0	1	3
OG0009234	0	0	0	0	2	0	1	3
OG0009235	0	0	0	0	2	0	1	3
OG0009236	0	0	0	0	2	0	1	3
OG0009237	0	0	0	0	1	0	2	3
OG0009238	0	0	0	0	1	0	2	3
OG0009239	0	0	0	0	1	1	1	3
OG0009240	0	0	0	0	1	1	1	3
OG0009241	0	0	0	0	2	0	1	3
OG0009242	0	0	0	0	1	1	1	3
OG0009243	0	0	0	0	2	0	1	3
OG0009244	0	0	0	0	1	0	2	3
OG0009245	0	0	0	0	2	0	1	3
OG0009246	0	0	0	0	2	0	1	3
OG0009247	0	0	0	0	2	0	1	3
OG0009248	0	0	0	0	2	0	1	3
OG0009249	0	0	0	0	2	0	1	3
OG0009250	0	0	0	0	2	0	1	3
OG0009251	0	0	0	0	1	0	2	3
OG0009252	0	0	0	0	2	0	1	3
OG0009253	0	0	0	0	1	0	2	3
OG0009254	0	0	0	0	1	1	1	3
OG0009255	0	0	0	0	2	0	1	3
OG0009256	0	0	0	0	1	1	1	3
OG0009257	0	0	0	0	2	0	1	3
OG0009258	0	0	0	0	2	0	1	3
OG0009259	0	0	0	0	3	0	0	3
OG0009260	0	0	0	0	1	1	1	3
OG0009261	0	0	0	0	2	0	1	3
OG0009262	0	0	0	0	1	2	0	3
OG0009263	0	0	0	0	1	1	1	3
OG0009264	0	0	0	0	2	0	1	3
OG0009265	0	0	0	0	1	0	2	3
OG0009266	0	0	0	0	1	0	2	3
OG0009267	0	0	0	0	1	1	1	3
OG0009268	0	0	0	0	2	0	1	3
OG0009269	0	0	0	0	1	1	1	3
OG0009270	0	0	0	0	1	0	2	3
OG0009271	0	0	0	0	2	0	1	3
OG0009272	0	0	0	0	1	0	2	3
OG0009273	0	0	0	0	1	1	1	3
OG0009274	0	0	0	0	1	1	1	3
OG0009275	0	0	0	0	1	1	1	3
OG0009276	0	0	0	0	3	0	0	3
OG0009277	0	0	0	0	2	0	1	3
OG0009278	0	0	0	0	2	0	1	3
OG0009279	0	0	0	0	1	0	2	3
OG0009280	0	0	0	0	1	0	2	3
OG0009281	0	0	0	0	2	0	1	3
OG0009282	0	0	0	0	1	0	2	3
OG0009283	0	0	0	0	2	0	1	3
OG0009284	0	0	0	0	1	1	1	3
OG0009285	0	0	0	0	2	0	1	3
OG0009286	0	0	0	0	1	1	1	3
OG0009287	0	0	0	0	1	1	1	3
OG0009288	0	0	0	0	3	0	0	3
OG0009289	0	0	0	0	1	0	2	3
OG0009290	0	0	0	0	1	1	1	3
OG0009291	0	0	0	0	2	0	1	3
OG0009292	0	0	0	0	1	0	2	3
OG0009293	0	0	0	0	1	0	2	3
OG0009294	0	0	0	0	1	1	1	3
OG0009295	0	0	0	0	2	0	1	3
OG0009296	0	0	0	0	1	0	2	3
OG0009297	0	0	0	0	3	0	0	3
OG0009298	0	0	0	0	2	0	1	3
OG0009299	0	0	0	0	2	0	1	3
OG0009300	0	0	0	0	1	1	1	3
OG0009301	0	0	0	0	1	1	1	3
OG0009302	0	0	0	0	2	0	1	3
OG0009303	0	0	0	0	2	0	1	3
OG0009304	0	0	0	0	1	0	2	3
OG0009305	0	0	0	0	3	0	0	3
OG0009306	0	0	0	0	1	1	1	3
OG0009307	0	0	0	0	2	0	1	3
OG0009308	0	0	0	0	2	0	1	3
OG0009309	0	0	0	0	1	0	2	3
OG0009310	0	0	0	0	1	1	1	3
OG0009311	0	0	0	0	1	1	1	3
OG0009312	0	0	0	0	2	0	1	3
OG0009313	0	0	0	0	1	0	2	3
OG0009314	0	0	0	0	1	0	2	3
OG0009315	0	0	0	0	1	0	2	3
OG0009316	0	0	0	0	2	0	1	3
OG0009317	0	0	0	0	2	0	1	3
OG0009318	0	0	0	0	1	0	2	3
OG0009319	0	0	0	0	1	0	2	3
OG0009320	0	0	0	0	1	1	1	3
OG0009321	0	0	0	0	1	0	2	3
OG0009322	0	0	0	0	1	0	2	3
OG0009323	0	0	0	0	1	0	2	3
OG0009324	0	0	0	0	1	0	2	3
OG0009325	0	0	0	0	1	0	2	3
OG0009326	0	0	0	0	1	0	2	3
OG0009327	0	0	0	0	1	1	1	3
OG0009328	0	0	0	0	1	1	1	3
OG0009329	0	0	0	0	1	0	2	3
OG0009330	0	0	0	0	1	0	2	3
OG0009331	0	0	0	0	2	0	1	3
OG0009332	0	0	0	0	2	0	1	3
OG0009333	0	0	0	0	1	0	2	3
OG0009334	0	0	0	0	1	0	2	3
OG0009335	0	0	0	0	1	1	1	3
OG0009336	0	0	0	0	1	0	2	3
OG0009337	0	0	0	0	1	0	2	3
OG0009338	0	0	0	0	1	0	2	3
OG0009339	0	0	0	0	2	0	1	3
OG0009340	0	0	0	0	1	1	1	3
OG0009341	0	0	0	0	1	1	1	3
OG0009342	0	0	0	0	2	0	1	3
OG0009343	0	0	0	0	1	0	2	3
OG0009344	0	0	0	0	1	1	1	3
OG0009345	0	0	0	0	1	1	1	3
OG0009346	0	0	0	0	1	0	2	3
OG0009347	0	0	0	0	1	1	1	3
OG0009348	0	0	0	0	1	1	1	3
OG0009349	0	0	0	0	2	0	1	3
OG0009350	0	0	0	0	1	1	1	3
OG0009351	0	0	0	0	1	0	2	3
OG0009352	0	0	0	0	1	1	1	3
OG0009353	0	0	0	0	1	1	1	3
OG0009354	0	0	0	0	1	1	1	3
OG0009355	0	0	0	0	1	0	2	3
OG0009356	0	0	0	0	2	0	1	3
OG0009357	0	0	0	0	1	1	1	3
OG0009358	0	0	0	0	1	1	1	3
OG0009359	0	0	0	0	1	1	1	3
OG0009360	0	0	0	0	1	1	1	3
OG0009361	0	0	0	0	1	1	1	3
OG0009362	0	0	0	0	1	1	1	3
OG0009363	0	0	0	0	2	0	1	3
OG0009364	0	0	0	0	1	0	2	3
OG0009365	0	0	0	0	1	0	2	3
OG0009366	0	0	0	0	1	1	1	3
OG0009367	0	0	0	0	1	0	2	3
OG0009368	0	0	0	0	2	0	1	3
OG0009369	0	0	0	0	1	0	2	3
OG0009370	0	0	0	0	1	1	1	3
OG0009371	0	0	0	0	1	0	2	3
OG0009372	0	0	0	0	1	1	1	3
OG0009373	0	0	0	0	1	0	2	3
OG0009374	0	0	0	0	2	0	1	3
OG0009375	0	0	0	0	3	0	0	3
OG0009376	0	0	0	0	2	0	1	3
OG0009377	0	0	0	0	2	0	1	3
OG0009378	0	0	0	0	2	0	1	3
OG0009379	0	0	0	0	1	1	1	3
OG0009380	0	0	0	0	2	0	1	3
OG0009381	0	0	0	0	1	0	2	3
OG0009382	0	0	0	0	1	1	1	3
OG0009383	0	0	0	0	1	1	1	3
OG0009384	0	0	0	0	1	1	1	3
OG0009385	0	0	0	0	1	1	1	3
OG0009386	0	0	0	0	1	0	2	3
OG0009387	0	0	0	0	1	1	1	3
OG0009388	0	0	0	0	1	1	1	3
OG0009389	0	0	0	0	1	1	1	3
OG0009390	0	0	0	0	2	0	1	3
OG0009391	0	0	0	0	2	0	1	3
OG0009392	0	0	0	0	1	0	2	3
OG0009393	0	0	0	0	1	0	2	3
OG0009394	0	0	0	0	1	0	2	3
OG0009395	0	0	0	0	1	0	2	3
OG0009396	0	0	0	0	2	0	1	3
OG0009397	0	0	0	0	1	1	1	3
OG0009398	0	0	0	0	1	1	1	3
OG0009399	0	0	0	0	1	0	2	3
OG0009400	0	0	0	0	1	1	1	3
OG0009401	0	0	0	0	1	1	1	3
OG0009402	0	0	0	0	1	1	1	3
OG0009403	0	0	0	0	1	0	2	3
OG0009404	0	0	0	0	1	0	2	3
OG0009405	0	0	0	0	1	0	2	3
OG0009406	0	0	0	0	2	0	1	3
OG0009407	0	0	0	0	1	1	1	3
OG0009408	0	0	0	0	1	1	1	3
OG0009409	0	0	0	0	1	0	2	3
OG0009410	0	0	0	0	2	0	1	3
OG0009411	0	0	0	0	2	0	1	3
OG0009412	0	0	0	0	1	1	1	3
OG0009413	0	0	0	0	2	0	1	3
OG0009414	0	0	0	0	1	1	1	3
OG0009415	0	0	0	0	1	1	1	3
OG0009416	0	0	0	0	1	1	1	3
OG0009417	0	0	0	0	3	0	0	3
OG0009418	0	0	0	0	1	1	1	3
OG0009419	0	0	0	0	1	1	1	3
OG0009420	0	0	0	0	1	1	1	3
OG0009421	0	0	0	0	3	0	0	3
OG0009422	0	0	0	0	1	1	1	3
OG0009423	0	0	0	0	1	0	2	3
OG0009424	0	0	0	0	1	0	2	3
OG0009425	0	0	0	0	1	0	2	3
OG0009426	0	0	0	0	1	0	2	3
OG0009427	0	0	0	0	1	0	2	3
OG0009428	0	0	0	0	1	0	2	3
OG0009429	0	0	0	0	1	0	2	3
OG0009430	0	0	0	0	1	0	2	3
OG0009431	0	0	0	0	1	0	2	3
OG0009432	0	0	0	0	2	0	1	3
OG0009433	0	0	0	0	2	0	1	3
OG0009434	0	0	0	0	2	0	1	3
OG0009435	0	0	0	0	1	1	1	3
OG0009436	0	0	0	0	1	0	2	3
OG0009437	0	0	0	0	1	1	1	3
OG0009438	0	0	0	0	1	0	2	3
OG0009439	0	0	0	0	1	1	1	3
OG0009440	0	0	0	0	1	1	1	3
OG0009441	0	0	0	0	1	0	2	3
OG0009442	0	0	0	0	2	0	1	3
OG0009443	0	0	0	0	1	0	2	3
OG0009444	0	0	0	0	1	0	2	3
OG0009445	0	0	0	0	2	0	1	3
OG0009446	0	0	0	0	2	0	1	3
OG0009447	0	0	0	0	2	0	1	3
OG0009448	0	0	0	0	1	1	1	3
OG0009449	0	0	0	0	1	0	2	3
OG0009450	0	0	0	0	1	1	1	3
OG0009451	0	0	0	0	2	0	1	3
OG0009452	0	0	0	0	1	1	1	3
OG0009453	0	0	0	0	1	1	1	3
OG0009454	0	0	0	0	1	1	1	3
OG0009455	0	0	0	0	1	1	1	3
OG0009456	0	0	0	0	1	1	1	3
OG0009457	0	0	0	0	1	1	1	3
OG0009458	0	0	0	0	1	1	1	3
OG0009459	0	0	0	0	2	0	1	3
OG0009460	0	0	0	0	2	0	1	3
OG0009461	0	0	0	0	1	1	1	3
OG0009462	0	0	0	0	1	1	1	3
OG0009463	0	0	0	0	1	0	2	3
OG0009464	0	0	0	0	1	0	2	3
OG0009465	0	0	0	0	1	0	2	3
OG0009466	0	0	0	0	1	0	2	3
OG0009467	0	0	0	0	1	0	2	3
OG0009468	0	0	0	0	1	0	2	3
OG0009469	0	0	0	0	1	0	2	3
OG0009470	0	0	0	0	1	0	2	3
OG0009471	0	0	0	0	1	0	2	3
OG0009472	0	0	0	0	1	0	2	3
OG0009473	0	0	0	0	1	0	2	3
OG0009474	0	0	0	0	1	0	2	3
OG0009475	0	0	0	0	1	1	1	3
OG0009476	0	0	0	0	1	1	1	3
OG0009477	0	0	0	0	1	1	1	3
OG0009478	0	0	0	0	1	1	1	3
OG0009479	0	0	0	0	1	1	1	3
OG0009480	0	0	0	0	1	0	2	3
OG0009481	0	0	0	0	1	0	2	3
OG0009482	0	0	0	0	1	0	2	3
OG0009483	0	0	0	0	1	0	2	3
OG0009484	0	0	0	0	1	1	1	3
OG0009485	0	0	0	0	1	1	1	3
OG0009486	0	0	0	0	2	0	1	3
OG0009487	0	0	0	0	1	1	1	3
OG0009488	0	0	0	0	1	1	1	3
OG0009489	0	0	0	0	1	0	2	3
OG0009490	0	0	0	0	1	1	1	3
OG0009491	0	0	0	0	1	0	2	3
OG0009492	0	0	0	0	2	0	1	3
OG0009493	0	0	0	0	2	0	1	3
OG0009494	0	0	0	0	1	1	1	3
OG0009495	0	0	0	0	2	0	1	3
OG0009496	0	0	0	0	1	0	2	3
OG0009497	0	0	0	0	1	1	1	3
OG0009498	0	0	0	0	2	0	1	3
OG0009499	0	0	0	0	1	0	2	3
OG0009500	0	0	0	0	1	1	1	3
OG0009501	0	0	0	0	1	1	1	3
OG0009502	0	0	0	0	1	1	1	3
OG0009503	0	0	0	0	1	1	1	3
OG0009504	0	0	0	0	1	0	2	3
OG0009505	0	0	0	0	2	0	1	3
OG0009506	0	0	0	0	1	0	2	3
OG0009507	0	0	0	0	1	0	2	3
OG0009508	0	0	0	0	1	0	2	3
OG0009509	0	0	0	0	1	1	1	3
OG0009510	0	0	0	0	2	0	1	3
OG0009511	0	0	0	0	1	0	2	3
OG0009512	0	0	0	0	1	0	2	3
OG0009513	0	0	0	0	1	0	2	3
OG0009514	0	0	0	0	1	1	1	3
OG0009515	0	0	0	0	1	0	2	3
OG0009516	0	0	0	0	1	0	2	3
OG0009517	0	0	0	0	1	1	1	3
OG0009518	0	0	0	0	2	0	1	3
OG0009519	0	0	0	0	1	0	2	3
OG0009520	0	0	0	0	1	1	1	3
OG0009521	0	0	0	0	1	1	1	3
OG0009522	0	0	0	0	1	0	2	3
OG0009523	0	0	0	0	1	1	1	3
OG0009524	0	0	0	0	1	0	2	3
OG0009525	0	0	0	0	1	1	1	3
OG0009526	0	0	0	0	1	0	2	3
OG0009527	0	0	0	0	0	3	0	3
OG0009528	0	0	0	0	0	3	0	3
OG0009529	0	0	0	0	0	3	0	3
OG0009530	0	0	0	0	0	3	0	3
OG0009531	0	0	0	0	0	3	0	3
OG0009532	0	0	0	0	0	3	0	3
OG0009533	0	0	0	0	0	3	0	3
OG0009534	0	0	0	0	0	3	0	3
OG0009535	0	0	0	0	0	3	0	3
OG0009536	0	0	0	0	0	3	0	3
OG0009537	0	0	0	0	0	3	0	3
OG0009538	0	0	0	0	0	3	0	3
OG0009539	0	0	0	0	0	3	0	3
OG0009540	0	0	0	0	0	3	0	3
OG0009541	0	0	0	0	0	3	0	3
OG0009542	0	0	0	0	0	3	0	3
OG0009543	0	0	0	0	0	3	0	3
OG0009544	0	0	0	0	0	3	0	3
OG0009545	0	0	0	0	0	3	0	3
OG0009546	0	0	0	0	0	3	0	3
OG0009547	0	0	0	0	0	3	0	3
OG0009548	0	0	0	0	0	2	1	3
OG0009549	0	0	0	0	0	3	0	3
OG0009550	0	0	0	0	0	3	0	3
OG0009551	0	0	0	0	0	3	0	3
OG0009552	0	0	0	0	0	3	0	3
OG0009553	0	0	0	0	0	3	0	3
OG0009554	0	0	0	0	0	3	0	3
OG0009555	0	0	0	0	0	3	0	3
OG0009556	0	0	0	0	0	3	0	3
OG0009557	0	0	0	0	0	2	1	3
OG0009558	0	0	0	0	0	3	0	3
OG0009559	0	0	0	0	0	3	0	3
OG0009560	0	0	0	0	0	3	0	3
OG0009561	0	0	0	0	0	3	0	3
OG0009562	0	0	0	0	0	2	1	3
OG0009563	0	0	0	0	0	3	0	3
OG0009564	0	0	0	0	0	3	0	3
OG0009565	0	0	0	0	0	3	0	3
OG0009566	0	0	0	0	0	3	0	3
OG0009567	0	0	0	0	0	3	0	3
OG0009568	0	0	0	0	0	2	1	3
OG0009569	0	0	0	0	0	3	0	3
OG0009570	0	0	0	0	0	3	0	3
OG0009571	0	0	0	0	0	3	0	3
OG0009572	0	0	0	0	0	3	0	3
OG0009573	0	0	0	0	0	3	0	3
OG0009574	0	0	0	0	0	1	2	3
OG0009575	0	0	0	0	0	3	0	3
OG0009576	0	0	0	0	0	3	0	3
OG0009577	0	0	0	0	0	3	0	3
OG0009578	0	0	0	0	0	3	0	3
OG0009579	0	0	0	0	0	3	0	3
OG0009580	0	0	0	0	0	1	2	3
OG0009581	0	0	0	0	0	3	0	3
OG0009582	0	0	0	0	0	3	0	3
OG0009583	0	0	0	0	0	3	0	3
OG0009584	0	0	0	0	0	3	0	3
OG0009585	0	0	0	0	0	3	0	3
OG0009586	0	0	0	0	0	3	0	3
OG0009587	0	0	0	0	0	3	0	3
OG0009588	0	0	0	0	0	3	0	3
OG0009589	0	0	0	0	0	3	0	3
OG0009590	0	0	0	0	0	3	0	3
OG0009591	0	0	0	0	0	3	0	3
OG0009592	0	0	0	0	0	3	0	3
OG0009593	0	0	0	0	0	3	0	3
OG0009594	0	0	0	0	0	3	0	3
OG0009595	0	0	0	0	0	3	0	3
OG0009596	0	0	0	0	0	3	0	3
OG0009597	0	0	0	0	0	1	2	3
OG0009598	0	0	0	0	0	3	0	3
OG0009599	0	0	0	0	0	3	0	3
OG0009600	0	0	0	0	0	3	0	3
OG0009601	0	0	0	0	0	3	0	3
OG0009602	0	0	0	0	0	3	0	3
OG0009603	0	0	0	0	0	3	0	3
OG0009604	0	0	0	0	0	3	0	3
OG0009605	0	0	0	0	0	3	0	3
OG0009606	0	0	0	0	0	1	2	3
OG0009607	0	0	0	0	0	3	0	3
OG0009608	0	0	0	0	0	0	3	3
OG0009609	0	0	0	0	0	0	3	3
OG0009610	0	0	0	0	0	0	3	3
OG0009611	0	0	0	0	0	0	3	3
OG0009612	0	0	0	0	0	0	3	3
OG0009613	0	0	0	0	0	0	3	3
OG0009614	0	0	0	0	0	0	3	3
OG0009615	0	0	0	0	0	0	3	3
OG0009616	0	0	0	0	0	0	3	3
OG0009617	0	0	0	0	0	0	3	3
OG0009618	0	0	0	0	0	0	3	3
OG0009619	0	0	0	0	0	0	3	3
OG0009620	0	0	0	0	0	0	3	3
OG0009621	0	0	0	0	0	0	3	3
OG0009622	0	0	0	0	0	0	3	3
OG0009623	0	0	0	0	0	0	3	3
OG0009624	0	0	0	0	0	0	3	3
OG0009625	0	0	0	0	0	0	3	3
OG0009626	0	0	0	0	0	0	3	3
OG0009627	0	0	0	0	0	0	3	3
OG0009628	0	0	0	0	0	0	3	3
OG0009629	0	0	0	0	0	0	3	3
OG0009630	0	0	0	0	0	0	3	3
OG0009631	0	0	0	0	0	0	3	3
OG0009632	0	0	0	0	0	0	3	3
OG0009633	0	0	0	0	0	0	3	3
OG0009634	0	0	0	0	0	0	3	3
OG0009635	0	0	0	0	0	0	3	3
OG0009636	0	0	0	0	0	0	3	3
OG0009637	0	0	0	0	0	0	3	3
OG0009638	0	0	0	0	0	0	3	3
OG0009639	0	0	0	0	0	0	3	3
OG0009640	0	0	0	0	0	0	3	3
OG0009641	0	0	0	0	0	0	3	3
OG0009642	0	0	0	0	0	0	3	3
OG0009643	0	0	0	0	0	0	3	3
OG0009644	0	0	0	0	0	0	3	3
OG0009645	0	0	0	0	0	0	3	3
OG0009646	0	0	0	0	0	0	3	3
OG0009647	0	0	0	0	0	0	3	3
OG0009648	0	0	0	0	0	0	3	3
OG0009649	0	0	0	0	0	0	3	3
OG0009650	0	0	0	0	0	0	3	3
OG0009651	0	0	0	0	0	0	3	3
OG0009652	0	0	0	0	0	0	3	3
OG0009653	0	0	0	0	0	0	3	3
OG0009654	0	0	0	0	0	0	3	3
OG0009655	0	0	0	0	0	0	3	3
OG0009656	0	0	0	0	0	0	3	3
OG0009657	0	0	0	0	0	0	3	3
OG0009658	0	0	0	0	0	0	3	3
OG0009659	0	0	0	0	0	0	3	3
OG0009660	0	0	0	0	0	0	3	3
OG0009661	0	0	0	0	0	0	3	3
OG0009662	0	0	0	0	0	0	3	3
OG0009663	0	0	0	0	0	0	3	3
OG0009664	0	0	0	0	0	0	3	3
OG0009665	0	0	0	0	0	0	3	3
OG0009666	0	0	0	0	0	0	3	3
OG0009667	0	0	0	0	0	0	3	3
OG0009668	0	0	0	0	0	0	3	3
OG0009669	0	0	0	0	0	0	3	3
OG0009670	0	0	0	0	0	0	3	3
OG0009671	0	0	0	0	0	0	3	3
OG0009672	0	0	0	0	0	0	3	3
OG0009673	0	0	0	0	0	0	3	3
OG0009674	0	0	0	0	0	0	3	3
OG0009675	0	0	0	0	0	0	3	3
OG0009676	0	0	0	0	0	0	3	3
OG0009677	0	0	0	0	0	0	3	3
OG0009678	0	0	0	0	0	0	3	3
OG0009679	0	0	0	0	0	0	3	3
OG0009680	0	0	0	0	0	0	3	3
OG0009681	0	0	0	0	0	0	3	3
OG0009682	0	0	0	0	0	0	3	3
OG0009683	0	0	0	0	0	0	3	3
OG0009684	0	0	0	0	0	0	3	3
OG0009685	0	0	0	0	0	0	3	3
OG0009686	0	0	0	0	0	0	3	3
OG0009687	0	0	0	0	0	0	3	3
OG0009688	0	0	0	0	0	0	3	3
OG0009689	0	0	0	0	0	0	3	3
OG0009690	0	0	0	0	0	0	3	3
OG0009691	0	0	0	0	0	0	3	3
OG0009692	0	0	0	0	0	0	3	3
OG0009693	0	0	0	0	0	0	3	3
OG0009694	0	0	0	0	0	0	3	3
OG0009695	0	0	0	0	0	0	3	3
OG0009696	0	0	0	0	0	0	3	3
OG0009697	0	0	0	0	0	0	3	3
OG0009698	0	0	0	0	0	0	3	3
OG0009699	0	0	0	0	0	0	3	3
OG0009700	0	0	0	0	0	0	3	3
OG0009701	0	0	0	0	0	0	3	3
OG0009702	0	0	0	0	0	0	3	3
OG0009703	0	0	0	0	0	0	3	3
OG0009704	0	0	0	0	0	0	3	3
OG0009705	0	0	0	0	0	0	3	3
OG0009706	0	0	0	0	0	0	3	3
OG0009707	0	0	0	0	0	0	3	3
OG0009708	0	0	0	0	0	0	3	3
OG0009709	0	0	0	0	0	0	3	3
OG0009710	0	0	0	0	0	0	3	3
OG0009711	0	0	0	0	0	0	3	3
OG0009712	0	0	0	0	0	0	3	3
OG0009713	0	0	0	0	0	0	3	3
OG0009714	0	0	0	0	0	0	3	3
OG0009715	0	0	0	0	0	0	3	3
OG0009716	0	0	0	0	0	0	3	3
OG0009717	0	0	0	0	0	0	3	3
OG0009718	0	0	0	0	0	0	3	3
OG0009719	0	0	0	0	0	0	3	3
OG0009720	0	0	0	0	0	0	3	3
OG0009721	0	0	0	0	0	0	3	3
OG0009722	0	0	0	0	0	0	3	3
OG0009723	0	0	0	0	0	0	3	3
OG0009724	0	0	0	0	0	0	3	3
OG0009725	0	0	0	0	0	0	3	3
OG0009726	0	0	0	0	0	0	3	3
OG0009727	0	0	0	0	0	0	3	3
OG0009728	0	0	0	0	0	0	3	3
OG0009729	0	0	0	0	0	0	3	3
OG0009730	0	0	0	0	0	0	3	3
OG0009731	0	0	0	0	0	0	3	3
OG0009732	0	0	0	0	0	0	3	3
OG0009733	0	0	0	0	0	0	3	3
OG0009734	0	0	0	0	0	0	3	3
OG0009735	0	0	0	0	0	0	3	3
OG0009736	0	0	0	0	0	0	3	3
OG0009737	0	0	0	0	0	0	3	3
OG0009738	0	0	0	0	0	0	3	3
OG0009739	0	0	0	0	0	0	3	3
OG0009740	0	0	0	0	0	0	3	3
OG0009741	0	0	0	0	0	0	3	3
OG0009742	0	0	0	0	0	0	3	3
OG0009743	0	0	0	0	0	0	3	3
OG0009744	0	0	0	0	0	0	3	3
OG0009745	0	0	0	0	0	0	3	3
OG0009746	0	0	0	0	0	0	3	3
OG0009747	0	0	0	0	0	0	3	3
OG0009748	0	0	0	0	0	0	3	3
OG0009749	0	0	0	0	0	0	3	3
OG0009750	0	0	0	0	0	0	3	3
OG0009751	0	0	0	0	0	0	3	3
OG0009752	0	0	0	0	0	0	3	3
OG0009753	0	0	0	0	0	0	3	3
OG0009754	0	0	0	0	0	0	3	3
OG0009755	0	0	0	0	0	0	3	3
OG0009756	0	0	0	0	0	0	3	3
OG0009757	0	0	0	0	0	0	3	3
OG0009758	0	0	0	0	0	0	3	3
OG0009759	0	0	0	0	0	0	3	3
OG0009760	0	0	0	0	0	0	3	3
OG0009761	0	0	0	0	0	0	3	3
OG0009762	0	0	0	0	0	0	3	3
OG0009763	0	0	0	0	0	0	3	3
OG0009764	0	0	0	0	0	0	3	3
OG0009765	0	0	0	0	0	0	3	3
OG0009766	0	0	0	0	0	0	3	3
OG0009767	0	0	0	0	0	0	3	3
OG0009768	0	0	0	0	0	0	3	3
OG0009769	0	0	0	0	0	0	3	3
OG0009770	0	0	0	0	0	0	3	3
OG0009771	0	0	0	0	0	0	3	3
OG0009772	0	0	0	0	0	0	3	3
OG0009773	0	0	0	0	0	0	3	3
OG0009774	0	0	0	0	0	0	3	3
OG0009775	0	0	0	0	0	0	3	3
OG0009776	0	0	0	0	0	0	3	3
OG0009777	0	0	0	0	0	0	3	3
OG0009778	0	0	0	0	0	0	3	3
OG0009779	0	0	0	0	0	0	3	3
OG0009780	0	0	0	0	0	0	3	3
OG0009781	0	0	0	0	0	0	3	3
OG0009782	0	0	0	0	0	0	3	3
OG0009783	0	0	0	0	0	0	3	3
OG0009784	0	0	0	0	0	0	3	3
OG0009785	0	0	0	0	0	0	3	3
OG0009786	0	0	0	0	0	0	3	3
OG0009787	0	0	0	0	0	0	3	3
OG0009788	0	0	0	0	0	0	3	3
OG0009789	0	0	0	0	0	0	3	3
OG0009790	0	0	0	0	0	0	3	3
OG0009791	0	0	0	0	0	0	3	3
OG0009792	0	0	0	0	0	0	3	3
OG0009793	0	0	0	0	0	0	3	3
OG0009794	0	0	0	0	0	0	3	3
OG0009795	0	0	0	0	0	0	3	3
OG0009796	0	0	0	0	0	0	3	3
OG0009797	0	0	0	0	0	0	3	3
OG0009798	0	0	0	0	0	0	3	3
OG0009799	0	0	0	0	0	0	3	3
OG0009800	0	0	0	0	0	0	3	3
OG0009801	0	0	0	0	0	0	3	3
OG0009802	0	0	0	0	0	0	3	3
OG0009803	0	0	0	0	0	0	3	3
OG0009804	0	0	0	0	0	0	3	3
OG0009805	0	0	0	0	0	0	3	3
OG0009806	0	0	0	0	0	0	3	3
OG0009807	0	0	0	0	0	0	3	3
OG0009808	0	0	0	0	0	0	3	3
OG0009809	0	0	0	0	0	0	3	3
OG0009810	0	0	0	0	0	0	3	3
OG0009811	0	0	0	0	0	0	3	3
OG0009812	0	0	0	0	0	0	3	3
OG0009813	0	0	0	0	0	0	3	3
OG0009814	0	0	0	0	0	0	3	3
OG0009815	0	0	0	0	0	0	3	3
OG0009816	0	0	0	0	0	0	3	3
OG0009817	0	0	0	0	0	0	3	3
OG0009818	0	0	0	0	0	0	3	3
OG0009819	0	0	0	0	0	0	3	3
OG0009820	0	0	0	0	0	0	3	3
OG0009821	0	0	0	0	0	0	3	3
OG0009822	0	0	0	0	0	0	3	3
OG0009823	0	0	0	0	0	0	3	3
OG0009824	0	0	0	0	0	0	3	3
OG0009825	0	0	0	0	0	0	3	3
OG0009826	0	0	0	0	0	0	3	3
OG0009827	0	0	0	0	0	0	3	3
OG0009828	0	0	0	0	0	0	3	3
OG0009829	0	0	0	0	0	0	3	3
OG0009830	0	0	0	0	0	0	3	3
OG0009831	0	0	0	0	0	0	3	3
OG0009832	0	0	0	0	0	0	3	3
OG0009833	0	0	0	0	0	0	3	3
OG0009834	0	0	0	0	0	0	3	3
OG0009835	0	0	0	0	0	0	3	3
OG0009836	0	0	0	0	0	0	3	3
OG0009837	0	0	0	0	0	0	3	3
OG0009838	0	0	0	0	0	0	3	3
OG0009839	0	0	0	0	0	0	3	3
OG0009840	0	0	0	0	0	0	3	3
OG0009841	0	0	0	0	0	0	3	3
OG0009842	0	0	0	0	0	0	3	3
OG0009843	0	0	0	0	0	0	3	3
OG0009844	0	0	0	0	0	0	3	3
OG0009845	0	0	0	0	0	0	3	3
OG0009846	0	0	0	0	0	0	3	3
OG0009847	0	0	0	0	0	0	3	3
OG0009848	0	0	0	0	0	0	3	3
OG0009849	0	0	0	0	0	0	3	3
OG0009850	0	0	0	0	0	0	3	3
OG0009851	0	0	0	0	0	0	3	3
OG0009852	0	0	0	0	0	0	3	3
OG0009853	0	0	0	0	0	0	3	3
OG0009854	0	0	0	0	0	0	3	3
OG0009855	0	0	0	0	0	0	3	3
OG0009856	0	0	0	0	0	0	3	3
OG0009857	0	0	0	0	0	0	3	3
OG0009858	0	0	0	0	0	0	3	3
OG0009859	0	0	0	0	0	0	3	3
OG0009860	0	0	0	0	0	0	3	3
OG0009861	0	0	0	0	0	0	3	3
OG0009862	0	0	0	0	0	0	3	3
OG0009863	0	0	0	0	0	0	3	3
OG0009864	0	0	0	0	0	0	3	3
OG0009865	0	0	0	0	0	0	3	3
OG0009866	0	0	0	0	0	0	3	3
OG0009867	0	0	0	0	0	0	3	3
OG0009868	0	0	0	0	0	0	3	3
OG0009869	0	0	0	0	0	0	3	3
OG0009870	0	0	0	0	0	0	3	3
OG0009871	0	0	0	0	0	0	3	3
OG0009872	0	0	0	0	0	0	3	3
OG0009873	0	0	0	0	0	0	3	3
OG0009874	0	0	0	0	0	0	3	3
OG0009875	0	0	0	0	0	0	3	3
OG0009876	0	0	0	0	0	0	3	3
OG0009877	0	0	0	0	0	0	3	3
OG0009878	0	0	0	0	0	0	3	3
OG0009879	0	0	0	0	0	0	3	3
OG0009880	0	0	0	0	0	0	3	3
OG0009881	0	0	0	0	0	0	3	3
OG0009882	0	0	0	0	0	0	3	3
OG0009883	0	0	0	0	0	0	3	3
OG0009884	0	0	0	0	0	0	3	3
OG0009885	0	0	0	0	0	0	3	3
OG0009886	0	0	0	0	0	0	3	3
OG0009887	0	0	0	0	0	0	3	3
OG0009888	0	0	0	0	0	0	3	3
OG0009889	0	0	0	0	0	0	3	3
OG0009890	0	0	0	0	0	0	3	3
OG0009891	0	0	0	0	0	0	3	3
OG0009892	0	0	0	0	0	0	3	3
OG0009893	0	0	0	0	0	0	3	3
OG0009894	0	0	0	0	0	0	3	3
OG0009895	0	0	0	0	0	0	3	3
OG0009896	0	0	0	0	0	0	3	3
OG0009897	0	0	0	0	0	0	3	3
OG0009898	0	0	0	0	0	0	3	3
OG0009899	0	0	0	0	0	0	3	3
OG0009900	0	0	0	0	0	0	3	3
OG0009901	0	0	0	0	0	0	3	3
OG0009902	0	0	0	0	0	0	3	3
OG0009903	0	0	0	0	0	0	3	3
OG0009904	0	0	0	0	0	0	3	3
OG0009905	0	0	0	0	0	0	3	3
OG0009906	0	0	0	0	0	0	3	3
OG0009907	0	0	0	0	0	0	3	3
OG0009908	0	0	0	0	0	0	3	3
OG0009909	0	0	0	0	0	0	3	3
OG0009910	0	0	0	0	0	0	3	3
OG0009911	0	0	0	0	0	0	3	3
OG0009912	0	0	0	0	0	0	3	3
OG0009913	0	0	0	0	0	0	3	3
OG0009914	0	0	0	0	0	0	3	3
OG0009915	0	0	0	0	0	0	3	3
OG0009916	0	0	0	0	0	0	3	3
OG0009917	0	0	0	0	0	0	3	3
OG0009918	0	0	0	0	0	0	3	3
OG0009919	0	0	0	0	0	0	3	3
OG0009920	0	0	0	0	0	0	3	3
OG0009921	0	0	0	0	0	0	3	3
OG0009922	0	0	0	0	0	0	3	3
OG0009923	0	0	0	0	0	0	3	3
OG0009924	0	0	0	0	0	0	3	3
OG0009925	0	0	0	0	0	0	3	3
OG0009926	0	0	0	0	0	0	3	3
OG0009927	0	0	0	0	0	0	3	3
OG0009928	0	0	0	0	0	0	3	3
OG0009929	0	0	0	0	0	0	3	3
OG0009930	0	0	0	0	0	0	3	3
OG0009931	0	0	0	0	0	0	3	3
OG0009932	0	0	0	0	0	0	3	3
OG0009933	0	0	0	0	0	0	3	3
OG0009934	0	0	0	0	0	0	3	3
OG0009935	0	0	0	0	0	0	3	3
OG0009936	0	0	0	0	0	0	3	3
OG0009937	0	0	0	0	0	0	3	3
OG0009938	0	0	0	0	0	0	3	3
OG0009939	0	0	0	0	0	0	3	3
OG0009940	0	0	0	0	0	0	3	3
OG0009941	0	0	0	0	0	0	3	3
OG0009942	0	0	0	0	0	0	3	3
OG0009943	0	0	0	0	0	0	3	3
OG0009944	0	0	0	0	0	0	3	3
OG0009945	0	0	0	0	0	0	3	3
OG0009946	0	0	0	0	0	0	3	3
OG0009947	0	0	0	0	0	0	3	3
OG0009948	0	0	0	0	0	0	3	3
OG0009949	0	0	0	0	0	0	3	3
OG0009950	0	0	0	0	0	0	3	3
OG0009951	0	0	0	0	0	0	3	3
OG0009952	0	0	0	0	0	0	3	3
OG0009953	0	0	0	0	0	0	3	3
OG0009954	0	0	0	0	0	0	3	3
OG0009955	0	0	0	0	0	0	3	3
OG0009956	0	0	0	0	0	0	3	3
OG0009957	0	0	0	0	0	0	3	3
OG0009958	0	0	0	0	0	0	3	3
OG0009959	0	0	0	0	0	0	3	3
OG0009960	0	0	0	0	0	0	3	3
OG0009961	0	0	0	0	0	0	3	3
OG0009962	0	0	0	0	0	0	3	3
OG0009963	0	0	0	0	0	0	3	3
OG0009964	0	0	0	0	0	0	3	3
OG0009965	0	0	0	0	0	0	3	3
OG0009966	0	0	0	0	0	0	3	3
OG0009967	0	0	0	0	0	0	3	3
OG0009968	0	0	0	0	0	0	3	3
OG0009969	0	0	0	0	0	0	3	3
OG0009970	0	0	0	0	0	0	3	3
OG0009971	0	0	0	0	0	0	3	3
OG0009972	0	0	0	0	0	0	3	3
OG0009973	0	0	0	0	0	0	3	3
OG0009974	0	0	0	0	0	0	3	3
OG0009975	0	0	0	0	0	0	3	3
OG0009976	0	0	0	0	0	0	3	3
OG0009977	0	0	0	0	0	0	3	3
OG0009978	0	0	0	0	0	0	3	3
OG0009979	0	0	0	0	0	0	3	3
OG0009980	0	0	0	0	0	0	3	3
OG0009981	0	0	0	0	0	0	3	3
OG0009982	0	0	0	0	0	0	3	3
OG0009983	0	0	0	0	0	0	3	3
OG0009984	0	0	0	0	0	0	3	3
OG0009985	0	0	0	0	0	0	3	3
OG0009986	0	0	0	0	0	0	3	3
OG0009987	0	0	0	0	0	0	3	3
OG0009988	0	0	0	0	0	0	3	3
OG0009989	0	0	0	0	0	0	3	3
OG0009990	0	0	0	0	0	0	3	3
OG0009991	0	0	0	0	0	0	3	3
OG0009992	0	0	0	0	0	0	3	3
OG0009993	0	0	0	0	0	0	3	3
OG0009994	0	0	0	0	0	0	3	3
OG0009995	0	0	0	0	0	0	3	3
OG0009996	0	0	0	0	0	0	3	3
OG0009997	0	0	0	0	0	0	3	3
OG0009998	0	0	0	0	0	0	3	3
OG0009999	0	0	0	0	0	0	3	3
OG0010000	0	0	0	0	0	0	3	3
OG0010001	0	0	0	0	0	0	3	3
OG0010002	0	0	0	0	0	0	3	3
OG0010003	0	0	0	0	0	0	3	3
OG0010004	0	0	0	0	0	0	3	3
OG0010005	0	0	0	0	0	0	3	3
OG0010006	0	0	0	0	0	0	3	3
OG0010007	0	0	0	0	0	0	3	3
OG0010008	0	0	0	0	0	0	3	3
OG0010009	0	0	0	0	0	0	3	3
OG0010010	0	0	0	0	0	0	3	3
OG0010011	0	0	0	0	0	0	3	3
OG0010012	0	0	0	0	0	0	3	3
OG0010013	0	0	0	0	0	0	3	3
OG0010014	0	0	0	0	0	0	3	3
OG0010015	0	0	0	0	0	0	3	3
OG0010016	0	0	0	0	0	0	3	3
OG0010017	0	0	0	0	0	0	3	3
OG0010018	0	0	0	0	0	0	3	3
OG0010019	0	0	0	0	0	0	3	3
OG0010020	0	0	0	0	0	0	3	3
OG0010021	0	0	0	0	0	0	3	3
OG0010022	0	0	0	0	0	0	3	3
OG0010023	0	0	0	0	0	0	3	3
OG0010024	0	0	0	0	0	0	3	3
OG0010025	0	0	0	0	0	0	3	3
OG0010026	0	0	0	0	0	0	3	3
OG0010027	0	0	0	0	0	0	3	3
OG0010028	0	0	0	0	0	0	3	3
OG0010029	0	0	0	0	0	0	3	3
OG0010030	0	0	0	0	0	0	3	3
OG0010031	0	0	0	0	0	0	3	3
OG0010032	0	0	0	0	0	0	3	3
OG0010033	0	0	0	0	0	0	3	3
OG0010034	0	0	0	0	0	0	3	3
OG0010035	0	0	0	0	0	0	3	3
OG0010036	0	0	0	0	0	0	3	3
OG0010037	0	0	0	0	0	0	3	3
OG0010038	0	0	0	0	0	0	3	3
OG0010039	0	0	0	0	0	0	3	3
OG0010040	0	0	0	0	0	0	3	3
OG0010041	0	0	0	0	0	0	3	3
OG0010042	0	0	0	0	0	0	3	3
OG0010043	0	0	0	0	0	0	3	3
OG0010044	0	0	0	0	0	0	3	3
OG0010045	0	0	0	0	0	0	3	3
OG0010046	0	0	0	0	0	0	3	3
OG0010047	0	0	0	0	0	0	3	3
OG0010048	0	0	0	0	0	0	3	3
OG0010049	0	0	0	0	0	0	3	3
OG0010050	0	0	0	0	0	0	3	3
OG0010051	2	0	0	0	0	0	0	2
OG0010052	2	0	0	0	0	0	0	2
OG0010053	2	0	0	0	0	0	0	2
OG0010054	2	0	0	0	0	0	0	2
OG0010055	2	0	0	0	0	0	0	2
OG0010056	2	0	0	0	0	0	0	2
OG0010057	2	0	0	0	0	0	0	2
OG0010058	2	0	0	0	0	0	0	2
OG0010059	2	0	0	0	0	0	0	2
OG0010060	2	0	0	0	0	0	0	2
OG0010061	2	0	0	0	0	0	0	2
OG0010062	2	0	0	0	0	0	0	2
OG0010063	2	0	0	0	0	0	0	2
OG0010064	2	0	0	0	0	0	0	2
OG0010065	2	0	0	0	0	0	0	2
OG0010066	2	0	0	0	0	0	0	2
OG0010067	2	0	0	0	0	0	0	2
OG0010068	2	0	0	0	0	0	0	2
OG0010069	2	0	0	0	0	0	0	2
OG0010070	2	0	0	0	0	0	0	2
OG0010071	2	0	0	0	0	0	0	2
OG0010072	2	0	0	0	0	0	0	2
OG0010073	2	0	0	0	0	0	0	2
OG0010074	2	0	0	0	0	0	0	2
OG0010075	2	0	0	0	0	0	0	2
OG0010076	2	0	0	0	0	0	0	2
OG0010077	2	0	0	0	0	0	0	2
OG0010078	2	0	0	0	0	0	0	2
OG0010079	2	0	0	0	0	0	0	2
OG0010080	2	0	0	0	0	0	0	2
OG0010081	1	0	0	0	0	0	1	2
OG0010082	2	0	0	0	0	0	0	2
OG0010083	2	0	0	0	0	0	0	2
OG0010084	2	0	0	0	0	0	0	2
OG0010085	2	0	0	0	0	0	0	2
OG0010086	2	0	0	0	0	0	0	2
OG0010087	2	0	0	0	0	0	0	2
OG0010088	2	0	0	0	0	0	0	2
OG0010089	2	0	0	0	0	0	0	2
OG0010090	2	0	0	0	0	0	0	2
OG0010091	2	0	0	0	0	0	0	2
OG0010092	2	0	0	0	0	0	0	2
OG0010093	2	0	0	0	0	0	0	2
OG0010094	2	0	0	0	0	0	0	2
OG0010095	2	0	0	0	0	0	0	2
OG0010096	2	0	0	0	0	0	0	2
OG0010097	2	0	0	0	0	0	0	2
OG0010098	2	0	0	0	0	0	0	2
OG0010099	1	0	1	0	0	0	0	2
OG0010100	2	0	0	0	0	0	0	2
OG0010101	2	0	0	0	0	0	0	2
OG0010102	2	0	0	0	0	0	0	2
OG0010103	2	0	0	0	0	0	0	2
OG0010104	2	0	0	0	0	0	0	2
OG0010105	2	0	0	0	0	0	0	2
OG0010106	2	0	0	0	0	0	0	2
OG0010107	2	0	0	0	0	0	0	2
OG0010108	2	0	0	0	0	0	0	2
OG0010109	2	0	0	0	0	0	0	2
OG0010110	2	0	0	0	0	0	0	2
OG0010111	2	0	0	0	0	0	0	2
OG0010112	2	0	0	0	0	0	0	2
OG0010113	2	0	0	0	0	0	0	2
OG0010114	2	0	0	0	0	0	0	2
OG0010115	2	0	0	0	0	0	0	2
OG0010116	2	0	0	0	0	0	0	2
OG0010117	2	0	0	0	0	0	0	2
OG0010118	2	0	0	0	0	0	0	2
OG0010119	2	0	0	0	0	0	0	2
OG0010120	2	0	0	0	0	0	0	2
OG0010121	2	0	0	0	0	0	0	2
OG0010122	2	0	0	0	0	0	0	2
OG0010123	2	0	0	0	0	0	0	2
OG0010124	2	0	0	0	0	0	0	2
OG0010125	1	0	1	0	0	0	0	2
OG0010126	2	0	0	0	0	0	0	2
OG0010127	2	0	0	0	0	0	0	2
OG0010128	2	0	0	0	0	0	0	2
OG0010129	1	0	1	0	0	0	0	2
OG0010130	2	0	0	0	0	0	0	2
OG0010131	2	0	0	0	0	0	0	2
OG0010132	2	0	0	0	0	0	0	2
OG0010133	2	0	0	0	0	0	0	2
OG0010134	2	0	0	0	0	0	0	2
OG0010135	2	0	0	0	0	0	0	2
OG0010136	2	0	0	0	0	0	0	2
OG0010137	2	0	0	0	0	0	0	2
OG0010138	2	0	0	0	0	0	0	2
OG0010139	2	0	0	0	0	0	0	2
OG0010140	2	0	0	0	0	0	0	2
OG0010141	2	0	0	0	0	0	0	2
OG0010142	2	0	0	0	0	0	0	2
OG0010143	2	0	0	0	0	0	0	2
OG0010144	2	0	0	0	0	0	0	2
OG0010145	2	0	0	0	0	0	0	2
OG0010146	2	0	0	0	0	0	0	2
OG0010147	2	0	0	0	0	0	0	2
OG0010148	2	0	0	0	0	0	0	2
OG0010149	1	0	1	0	0	0	0	2
OG0010150	2	0	0	0	0	0	0	2
OG0010151	2	0	0	0	0	0	0	2
OG0010152	2	0	0	0	0	0	0	2
OG0010153	2	0	0	0	0	0	0	2
OG0010154	2	0	0	0	0	0	0	2
OG0010155	2	0	0	0	0	0	0	2
OG0010156	2	0	0	0	0	0	0	2
OG0010157	2	0	0	0	0	0	0	2
OG0010158	2	0	0	0	0	0	0	2
OG0010159	2	0	0	0	0	0	0	2
OG0010160	2	0	0	0	0	0	0	2
OG0010161	2	0	0	0	0	0	0	2
OG0010162	2	0	0	0	0	0	0	2
OG0010163	2	0	0	0	0	0	0	2
OG0010164	2	0	0	0	0	0	0	2
OG0010165	2	0	0	0	0	0	0	2
OG0010166	2	0	0	0	0	0	0	2
OG0010167	2	0	0	0	0	0	0	2
OG0010168	2	0	0	0	0	0	0	2
OG0010169	2	0	0	0	0	0	0	2
OG0010170	2	0	0	0	0	0	0	2
OG0010171	1	0	0	1	0	0	0	2
OG0010172	2	0	0	0	0	0	0	2
OG0010173	2	0	0	0	0	0	0	2
OG0010174	2	0	0	0	0	0	0	2
OG0010175	2	0	0	0	0	0	0	2
OG0010176	2	0	0	0	0	0	0	2
OG0010177	2	0	0	0	0	0	0	2
OG0010178	2	0	0	0	0	0	0	2
OG0010179	2	0	0	0	0	0	0	2
OG0010180	2	0	0	0	0	0	0	2
OG0010181	2	0	0	0	0	0	0	2
OG0010182	2	0	0	0	0	0	0	2
OG0010183	2	0	0	0	0	0	0	2
OG0010184	2	0	0	0	0	0	0	2
OG0010185	2	0	0	0	0	0	0	2
OG0010186	2	0	0	0	0	0	0	2
OG0010187	2	0	0	0	0	0	0	2
OG0010188	2	0	0	0	0	0	0	2
OG0010189	2	0	0	0	0	0	0	2
OG0010190	2	0	0	0	0	0	0	2
OG0010191	2	0	0	0	0	0	0	2
OG0010192	2	0	0	0	0	0	0	2
OG0010193	2	0	0	0	0	0	0	2
OG0010194	2	0	0	0	0	0	0	2
OG0010195	2	0	0	0	0	0	0	2
OG0010196	2	0	0	0	0	0	0	2
OG0010197	2	0	0	0	0	0	0	2
OG0010198	2	0	0	0	0	0	0	2
OG0010199	2	0	0	0	0	0	0	2
OG0010200	2	0	0	0	0	0	0	2
OG0010201	2	0	0	0	0	0	0	2
OG0010202	1	0	1	0	0	0	0	2
OG0010203	2	0	0	0	0	0	0	2
OG0010204	2	0	0	0	0	0	0	2
OG0010205	2	0	0	0	0	0	0	2
OG0010206	2	0	0	0	0	0	0	2
OG0010207	2	0	0	0	0	0	0	2
OG0010208	2	0	0	0	0	0	0	2
OG0010209	2	0	0	0	0	0	0	2
OG0010210	2	0	0	0	0	0	0	2
OG0010211	2	0	0	0	0	0	0	2
OG0010212	2	0	0	0	0	0	0	2
OG0010213	2	0	0	0	0	0	0	2
OG0010214	2	0	0	0	0	0	0	2
OG0010215	2	0	0	0	0	0	0	2
OG0010216	2	0	0	0	0	0	0	2
OG0010217	2	0	0	0	0	0	0	2
OG0010218	2	0	0	0	0	0	0	2
OG0010219	2	0	0	0	0	0	0	2
OG0010220	2	0	0	0	0	0	0	2
OG0010221	2	0	0	0	0	0	0	2
OG0010222	2	0	0	0	0	0	0	2
OG0010223	2	0	0	0	0	0	0	2
OG0010224	2	0	0	0	0	0	0	2
OG0010225	2	0	0	0	0	0	0	2
OG0010226	2	0	0	0	0	0	0	2
OG0010227	2	0	0	0	0	0	0	2
OG0010228	2	0	0	0	0	0	0	2
OG0010229	2	0	0	0	0	0	0	2
OG0010230	2	0	0	0	0	0	0	2
OG0010231	2	0	0	0	0	0	0	2
OG0010232	2	0	0	0	0	0	0	2
OG0010233	2	0	0	0	0	0	0	2
OG0010234	2	0	0	0	0	0	0	2
OG0010235	2	0	0	0	0	0	0	2
OG0010236	2	0	0	0	0	0	0	2
OG0010237	2	0	0	0	0	0	0	2
OG0010238	2	0	0	0	0	0	0	2
OG0010239	2	0	0	0	0	0	0	2
OG0010240	2	0	0	0	0	0	0	2
OG0010241	2	0	0	0	0	0	0	2
OG0010242	2	0	0	0	0	0	0	2
OG0010243	2	0	0	0	0	0	0	2
OG0010244	2	0	0	0	0	0	0	2
OG0010245	2	0	0	0	0	0	0	2
OG0010246	2	0	0	0	0	0	0	2
OG0010247	2	0	0	0	0	0	0	2
OG0010248	2	0	0	0	0	0	0	2
OG0010249	2	0	0	0	0	0	0	2
OG0010250	2	0	0	0	0	0	0	2
OG0010251	2	0	0	0	0	0	0	2
OG0010252	2	0	0	0	0	0	0	2
OG0010253	2	0	0	0	0	0	0	2
OG0010254	2	0	0	0	0	0	0	2
OG0010255	2	0	0	0	0	0	0	2
OG0010256	1	0	1	0	0	0	0	2
OG0010257	2	0	0	0	0	0	0	2
OG0010258	2	0	0	0	0	0	0	2
OG0010259	2	0	0	0	0	0	0	2
OG0010260	2	0	0	0	0	0	0	2
OG0010261	2	0	0	0	0	0	0	2
OG0010262	2	0	0	0	0	0	0	2
OG0010263	2	0	0	0	0	0	0	2
OG0010264	2	0	0	0	0	0	0	2
OG0010265	2	0	0	0	0	0	0	2
OG0010266	2	0	0	0	0	0	0	2
OG0010267	2	0	0	0	0	0	0	2
OG0010268	2	0	0	0	0	0	0	2
OG0010269	2	0	0	0	0	0	0	2
OG0010270	2	0	0	0	0	0	0	2
OG0010271	2	0	0	0	0	0	0	2
OG0010272	2	0	0	0	0	0	0	2
OG0010273	2	0	0	0	0	0	0	2
OG0010274	2	0	0	0	0	0	0	2
OG0010275	2	0	0	0	0	0	0	2
OG0010276	2	0	0	0	0	0	0	2
OG0010277	2	0	0	0	0	0	0	2
OG0010278	2	0	0	0	0	0	0	2
OG0010279	2	0	0	0	0	0	0	2
OG0010280	2	0	0	0	0	0	0	2
OG0010281	2	0	0	0	0	0	0	2
OG0010282	2	0	0	0	0	0	0	2
OG0010283	2	0	0	0	0	0	0	2
OG0010284	2	0	0	0	0	0	0	2
OG0010285	2	0	0	0	0	0	0	2
OG0010286	2	0	0	0	0	0	0	2
OG0010287	2	0	0	0	0	0	0	2
OG0010288	2	0	0	0	0	0	0	2
OG0010289	2	0	0	0	0	0	0	2
OG0010290	1	0	0	0	0	0	1	2
OG0010291	2	0	0	0	0	0	0	2
OG0010292	2	0	0	0	0	0	0	2
OG0010293	2	0	0	0	0	0	0	2
OG0010294	2	0	0	0	0	0	0	2
OG0010295	2	0	0	0	0	0	0	2
OG0010296	2	0	0	0	0	0	0	2
OG0010297	2	0	0	0	0	0	0	2
OG0010298	2	0	0	0	0	0	0	2
OG0010299	2	0	0	0	0	0	0	2
OG0010300	2	0	0	0	0	0	0	2
OG0010301	2	0	0	0	0	0	0	2
OG0010302	2	0	0	0	0	0	0	2
OG0010303	2	0	0	0	0	0	0	2
OG0010304	2	0	0	0	0	0	0	2
OG0010305	2	0	0	0	0	0	0	2
OG0010306	2	0	0	0	0	0	0	2
OG0010307	2	0	0	0	0	0	0	2
OG0010308	2	0	0	0	0	0	0	2
OG0010309	1	0	0	1	0	0	0	2
OG0010310	2	0	0	0	0	0	0	2
OG0010311	2	0	0	0	0	0	0	2
OG0010312	2	0	0	0	0	0	0	2
OG0010313	2	0	0	0	0	0	0	2
OG0010314	2	0	0	0	0	0	0	2
OG0010315	1	0	0	0	0	0	1	2
OG0010316	2	0	0	0	0	0	0	2
OG0010317	2	0	0	0	0	0	0	2
OG0010318	2	0	0	0	0	0	0	2
OG0010319	2	0	0	0	0	0	0	2
OG0010320	2	0	0	0	0	0	0	2
OG0010321	2	0	0	0	0	0	0	2
OG0010322	2	0	0	0	0	0	0	2
OG0010323	2	0	0	0	0	0	0	2
OG0010324	2	0	0	0	0	0	0	2
OG0010325	2	0	0	0	0	0	0	2
OG0010326	2	0	0	0	0	0	0	2
OG0010327	2	0	0	0	0	0	0	2
OG0010328	2	0	0	0	0	0	0	2
OG0010329	2	0	0	0	0	0	0	2
OG0010330	2	0	0	0	0	0	0	2
OG0010331	2	0	0	0	0	0	0	2
OG0010332	2	0	0	0	0	0	0	2
OG0010333	2	0	0	0	0	0	0	2
OG0010334	2	0	0	0	0	0	0	2
OG0010335	2	0	0	0	0	0	0	2
OG0010336	2	0	0	0	0	0	0	2
OG0010337	2	0	0	0	0	0	0	2
OG0010338	2	0	0	0	0	0	0	2
OG0010339	2	0	0	0	0	0	0	2
OG0010340	2	0	0	0	0	0	0	2
OG0010341	2	0	0	0	0	0	0	2
OG0010342	2	0	0	0	0	0	0	2
OG0010343	2	0	0	0	0	0	0	2
OG0010344	2	0	0	0	0	0	0	2
OG0010345	2	0	0	0	0	0	0	2
OG0010346	2	0	0	0	0	0	0	2
OG0010347	2	0	0	0	0	0	0	2
OG0010348	2	0	0	0	0	0	0	2
OG0010349	2	0	0	0	0	0	0	2
OG0010350	2	0	0	0	0	0	0	2
OG0010351	2	0	0	0	0	0	0	2
OG0010352	2	0	0	0	0	0	0	2
OG0010353	2	0	0	0	0	0	0	2
OG0010354	2	0	0	0	0	0	0	2
OG0010355	2	0	0	0	0	0	0	2
OG0010356	2	0	0	0	0	0	0	2
OG0010357	2	0	0	0	0	0	0	2
OG0010358	2	0	0	0	0	0	0	2
OG0010359	2	0	0	0	0	0	0	2
OG0010360	2	0	0	0	0	0	0	2
OG0010361	2	0	0	0	0	0	0	2
OG0010362	2	0	0	0	0	0	0	2
OG0010363	2	0	0	0	0	0	0	2
OG0010364	2	0	0	0	0	0	0	2
OG0010365	2	0	0	0	0	0	0	2
OG0010366	1	0	0	0	0	1	0	2
OG0010367	2	0	0	0	0	0	0	2
OG0010368	2	0	0	0	0	0	0	2
OG0010369	2	0	0	0	0	0	0	2
OG0010370	2	0	0	0	0	0	0	2
OG0010371	2	0	0	0	0	0	0	2
OG0010372	1	1	0	0	0	0	0	2
OG0010373	2	0	0	0	0	0	0	2
OG0010374	2	0	0	0	0	0	0	2
OG0010375	2	0	0	0	0	0	0	2
OG0010376	2	0	0	0	0	0	0	2
OG0010377	2	0	0	0	0	0	0	2
OG0010378	2	0	0	0	0	0	0	2
OG0010379	2	0	0	0	0	0	0	2
OG0010380	2	0	0	0	0	0	0	2
OG0010381	1	0	1	0	0	0	0	2
OG0010382	2	0	0	0	0	0	0	2
OG0010383	2	0	0	0	0	0	0	2
OG0010384	2	0	0	0	0	0	0	2
OG0010385	2	0	0	0	0	0	0	2
OG0010386	2	0	0	0	0	0	0	2
OG0010387	2	0	0	0	0	0	0	2
OG0010388	2	0	0	0	0	0	0	2
OG0010389	2	0	0	0	0	0	0	2
OG0010390	2	0	0	0	0	0	0	2
OG0010391	2	0	0	0	0	0	0	2
OG0010392	2	0	0	0	0	0	0	2
OG0010393	2	0	0	0	0	0	0	2
OG0010394	2	0	0	0	0	0	0	2
OG0010395	2	0	0	0	0	0	0	2
OG0010396	2	0	0	0	0	0	0	2
OG0010397	2	0	0	0	0	0	0	2
OG0010398	2	0	0	0	0	0	0	2
OG0010399	2	0	0	0	0	0	0	2
OG0010400	2	0	0	0	0	0	0	2
OG0010401	2	0	0	0	0	0	0	2
OG0010402	2	0	0	0	0	0	0	2
OG0010403	2	0	0	0	0	0	0	2
OG0010404	2	0	0	0	0	0	0	2
OG0010405	2	0	0	0	0	0	0	2
OG0010406	2	0	0	0	0	0	0	2
OG0010407	2	0	0	0	0	0	0	2
OG0010408	2	0	0	0	0	0	0	2
OG0010409	2	0	0	0	0	0	0	2
OG0010410	2	0	0	0	0	0	0	2
OG0010411	2	0	0	0	0	0	0	2
OG0010412	2	0	0	0	0	0	0	2
OG0010413	2	0	0	0	0	0	0	2
OG0010414	2	0	0	0	0	0	0	2
OG0010415	2	0	0	0	0	0	0	2
OG0010416	2	0	0	0	0	0	0	2
OG0010417	2	0	0	0	0	0	0	2
OG0010418	2	0	0	0	0	0	0	2
OG0010419	2	0	0	0	0	0	0	2
OG0010420	2	0	0	0	0	0	0	2
OG0010421	2	0	0	0	0	0	0	2
OG0010422	2	0	0	0	0	0	0	2
OG0010423	2	0	0	0	0	0	0	2
OG0010424	2	0	0	0	0	0	0	2
OG0010425	2	0	0	0	0	0	0	2
OG0010426	2	0	0	0	0	0	0	2
OG0010427	2	0	0	0	0	0	0	2
OG0010428	2	0	0	0	0	0	0	2
OG0010429	2	0	0	0	0	0	0	2
OG0010430	2	0	0	0	0	0	0	2
OG0010431	2	0	0	0	0	0	0	2
OG0010432	2	0	0	0	0	0	0	2
OG0010433	1	0	0	0	0	0	1	2
OG0010434	2	0	0	0	0	0	0	2
OG0010435	2	0	0	0	0	0	0	2
OG0010436	2	0	0	0	0	0	0	2
OG0010437	2	0	0	0	0	0	0	2
OG0010438	2	0	0	0	0	0	0	2
OG0010439	2	0	0	0	0	0	0	2
OG0010440	2	0	0	0	0	0	0	2
OG0010441	2	0	0	0	0	0	0	2
OG0010442	2	0	0	0	0	0	0	2
OG0010443	2	0	0	0	0	0	0	2
OG0010444	2	0	0	0	0	0	0	2
OG0010445	1	0	0	1	0	0	0	2
OG0010446	2	0	0	0	0	0	0	2
OG0010447	2	0	0	0	0	0	0	2
OG0010448	2	0	0	0	0	0	0	2
OG0010449	2	0	0	0	0	0	0	2
OG0010450	2	0	0	0	0	0	0	2
OG0010451	2	0	0	0	0	0	0	2
OG0010452	2	0	0	0	0	0	0	2
OG0010453	2	0	0	0	0	0	0	2
OG0010454	2	0	0	0	0	0	0	2
OG0010455	2	0	0	0	0	0	0	2
OG0010456	2	0	0	0	0	0	0	2
OG0010457	2	0	0	0	0	0	0	2
OG0010458	2	0	0	0	0	0	0	2
OG0010459	2	0	0	0	0	0	0	2
OG0010460	2	0	0	0	0	0	0	2
OG0010461	2	0	0	0	0	0	0	2
OG0010462	2	0	0	0	0	0	0	2
OG0010463	2	0	0	0	0	0	0	2
OG0010464	2	0	0	0	0	0	0	2
OG0010465	2	0	0	0	0	0	0	2
OG0010466	2	0	0	0	0	0	0	2
OG0010467	2	0	0	0	0	0	0	2
OG0010468	1	0	0	1	0	0	0	2
OG0010469	2	0	0	0	0	0	0	2
OG0010470	2	0	0	0	0	0	0	2
OG0010471	2	0	0	0	0	0	0	2
OG0010472	2	0	0	0	0	0	0	2
OG0010473	2	0	0	0	0	0	0	2
OG0010474	1	0	1	0	0	0	0	2
OG0010475	2	0	0	0	0	0	0	2
OG0010476	2	0	0	0	0	0	0	2
OG0010477	2	0	0	0	0	0	0	2
OG0010478	2	0	0	0	0	0	0	2
OG0010479	2	0	0	0	0	0	0	2
OG0010480	2	0	0	0	0	0	0	2
OG0010481	2	0	0	0	0	0	0	2
OG0010482	2	0	0	0	0	0	0	2
OG0010483	2	0	0	0	0	0	0	2
OG0010484	2	0	0	0	0	0	0	2
OG0010485	2	0	0	0	0	0	0	2
OG0010486	2	0	0	0	0	0	0	2
OG0010487	2	0	0	0	0	0	0	2
OG0010488	2	0	0	0	0	0	0	2
OG0010489	1	1	0	0	0	0	0	2
OG0010490	2	0	0	0	0	0	0	2
OG0010491	2	0	0	0	0	0	0	2
OG0010492	1	0	0	0	0	1	0	2
OG0010493	2	0	0	0	0	0	0	2
OG0010494	2	0	0	0	0	0	0	2
OG0010495	2	0	0	0	0	0	0	2
OG0010496	2	0	0	0	0	0	0	2
OG0010497	2	0	0	0	0	0	0	2
OG0010498	2	0	0	0	0	0	0	2
OG0010499	2	0	0	0	0	0	0	2
OG0010500	2	0	0	0	0	0	0	2
OG0010501	2	0	0	0	0	0	0	2
OG0010502	2	0	0	0	0	0	0	2
OG0010503	2	0	0	0	0	0	0	2
OG0010504	2	0	0	0	0	0	0	2
OG0010505	2	0	0	0	0	0	0	2
OG0010506	2	0	0	0	0	0	0	2
OG0010507	2	0	0	0	0	0	0	2
OG0010508	2	0	0	0	0	0	0	2
OG0010509	2	0	0	0	0	0	0	2
OG0010510	2	0	0	0	0	0	0	2
OG0010511	2	0	0	0	0	0	0	2
OG0010512	2	0	0	0	0	0	0	2
OG0010513	2	0	0	0	0	0	0	2
OG0010514	1	0	0	0	1	0	0	2
OG0010515	2	0	0	0	0	0	0	2
OG0010516	2	0	0	0	0	0	0	2
OG0010517	2	0	0	0	0	0	0	2
OG0010518	2	0	0	0	0	0	0	2
OG0010519	2	0	0	0	0	0	0	2
OG0010520	2	0	0	0	0	0	0	2
OG0010521	2	0	0	0	0	0	0	2
OG0010522	2	0	0	0	0	0	0	2
OG0010523	2	0	0	0	0	0	0	2
OG0010524	2	0	0	0	0	0	0	2
OG0010525	2	0	0	0	0	0	0	2
OG0010526	2	0	0	0	0	0	0	2
OG0010527	2	0	0	0	0	0	0	2
OG0010528	2	0	0	0	0	0	0	2
OG0010529	2	0	0	0	0	0	0	2
OG0010530	2	0	0	0	0	0	0	2
OG0010531	2	0	0	0	0	0	0	2
OG0010532	2	0	0	0	0	0	0	2
OG0010533	2	0	0	0	0	0	0	2
OG0010534	2	0	0	0	0	0	0	2
OG0010535	2	0	0	0	0	0	0	2
OG0010536	1	0	0	0	0	1	0	2
OG0010537	2	0	0	0	0	0	0	2
OG0010538	2	0	0	0	0	0	0	2
OG0010539	2	0	0	0	0	0	0	2
OG0010540	2	0	0	0	0	0	0	2
OG0010541	2	0	0	0	0	0	0	2
OG0010542	2	0	0	0	0	0	0	2
OG0010543	2	0	0	0	0	0	0	2
OG0010544	2	0	0	0	0	0	0	2
OG0010545	2	0	0	0	0	0	0	2
OG0010546	2	0	0	0	0	0	0	2
OG0010547	2	0	0	0	0	0	0	2
OG0010548	1	0	0	0	0	1	0	2
OG0010549	2	0	0	0	0	0	0	2
OG0010550	2	0	0	0	0	0	0	2
OG0010551	2	0	0	0	0	0	0	2
OG0010552	2	0	0	0	0	0	0	2
OG0010553	2	0	0	0	0	0	0	2
OG0010554	2	0	0	0	0	0	0	2
OG0010555	1	0	0	1	0	0	0	2
OG0010556	2	0	0	0	0	0	0	2
OG0010557	2	0	0	0	0	0	0	2
OG0010558	2	0	0	0	0	0	0	2
OG0010559	2	0	0	0	0	0	0	2
OG0010560	2	0	0	0	0	0	0	2
OG0010561	2	0	0	0	0	0	0	2
OG0010562	2	0	0	0	0	0	0	2
OG0010563	2	0	0	0	0	0	0	2
OG0010564	2	0	0	0	0	0	0	2
OG0010565	2	0	0	0	0	0	0	2
OG0010566	2	0	0	0	0	0	0	2
OG0010567	2	0	0	0	0	0	0	2
OG0010568	2	0	0	0	0	0	0	2
OG0010569	2	0	0	0	0	0	0	2
OG0010570	2	0	0	0	0	0	0	2
OG0010571	1	0	1	0	0	0	0	2
OG0010572	2	0	0	0	0	0	0	2
OG0010573	2	0	0	0	0	0	0	2
OG0010574	2	0	0	0	0	0	0	2
OG0010575	2	0	0	0	0	0	0	2
OG0010576	2	0	0	0	0	0	0	2
OG0010577	2	0	0	0	0	0	0	2
OG0010578	2	0	0	0	0	0	0	2
OG0010579	2	0	0	0	0	0	0	2
OG0010580	2	0	0	0	0	0	0	2
OG0010581	2	0	0	0	0	0	0	2
OG0010582	2	0	0	0	0	0	0	2
OG0010583	2	0	0	0	0	0	0	2
OG0010584	2	0	0	0	0	0	0	2
OG0010585	2	0	0	0	0	0	0	2
OG0010586	2	0	0	0	0	0	0	2
OG0010587	2	0	0	0	0	0	0	2
OG0010588	2	0	0	0	0	0	0	2
OG0010589	2	0	0	0	0	0	0	2
OG0010590	2	0	0	0	0	0	0	2
OG0010591	2	0	0	0	0	0	0	2
OG0010592	2	0	0	0	0	0	0	2
OG0010593	2	0	0	0	0	0	0	2
OG0010594	2	0	0	0	0	0	0	2
OG0010595	1	0	0	0	0	1	0	2
OG0010596	2	0	0	0	0	0	0	2
OG0010597	2	0	0	0	0	0	0	2
OG0010598	2	0	0	0	0	0	0	2
OG0010599	2	0	0	0	0	0	0	2
OG0010600	2	0	0	0	0	0	0	2
OG0010601	2	0	0	0	0	0	0	2
OG0010602	2	0	0	0	0	0	0	2
OG0010603	2	0	0	0	0	0	0	2
OG0010604	2	0	0	0	0	0	0	2
OG0010605	2	0	0	0	0	0	0	2
OG0010606	2	0	0	0	0	0	0	2
OG0010607	2	0	0	0	0	0	0	2
OG0010608	2	0	0	0	0	0	0	2
OG0010609	2	0	0	0	0	0	0	2
OG0010610	2	0	0	0	0	0	0	2
OG0010611	2	0	0	0	0	0	0	2
OG0010612	2	0	0	0	0	0	0	2
OG0010613	2	0	0	0	0	0	0	2
OG0010614	2	0	0	0	0	0	0	2
OG0010615	2	0	0	0	0	0	0	2
OG0010616	2	0	0	0	0	0	0	2
OG0010617	2	0	0	0	0	0	0	2
OG0010618	2	0	0	0	0	0	0	2
OG0010619	2	0	0	0	0	0	0	2
OG0010620	2	0	0	0	0	0	0	2
OG0010621	2	0	0	0	0	0	0	2
OG0010622	2	0	0	0	0	0	0	2
OG0010623	2	0	0	0	0	0	0	2
OG0010624	2	0	0	0	0	0	0	2
OG0010625	2	0	0	0	0	0	0	2
OG0010626	2	0	0	0	0	0	0	2
OG0010627	2	0	0	0	0	0	0	2
OG0010628	2	0	0	0	0	0	0	2
OG0010629	1	0	1	0	0	0	0	2
OG0010630	2	0	0	0	0	0	0	2
OG0010631	1	0	1	0	0	0	0	2
OG0010632	2	0	0	0	0	0	0	2
OG0010633	2	0	0	0	0	0	0	2
OG0010634	2	0	0	0	0	0	0	2
OG0010635	2	0	0	0	0	0	0	2
OG0010636	2	0	0	0	0	0	0	2
OG0010637	2	0	0	0	0	0	0	2
OG0010638	2	0	0	0	0	0	0	2
OG0010639	2	0	0	0	0	0	0	2
OG0010640	1	0	1	0	0	0	0	2
OG0010641	2	0	0	0	0	0	0	2
OG0010642	2	0	0	0	0	0	0	2
OG0010643	2	0	0	0	0	0	0	2
OG0010644	2	0	0	0	0	0	0	2
OG0010645	2	0	0	0	0	0	0	2
OG0010646	2	0	0	0	0	0	0	2
OG0010647	2	0	0	0	0	0	0	2
OG0010648	2	0	0	0	0	0	0	2
OG0010649	2	0	0	0	0	0	0	2
OG0010650	2	0	0	0	0	0	0	2
OG0010651	2	0	0	0	0	0	0	2
OG0010652	2	0	0	0	0	0	0	2
OG0010653	2	0	0	0	0	0	0	2
OG0010654	2	0	0	0	0	0	0	2
OG0010655	2	0	0	0	0	0	0	2
OG0010656	2	0	0	0	0	0	0	2
OG0010657	2	0	0	0	0	0	0	2
OG0010658	2	0	0	0	0	0	0	2
OG0010659	2	0	0	0	0	0	0	2
OG0010660	2	0	0	0	0	0	0	2
OG0010661	2	0	0	0	0	0	0	2
OG0010662	2	0	0	0	0	0	0	2
OG0010663	2	0	0	0	0	0	0	2
OG0010664	2	0	0	0	0	0	0	2
OG0010665	2	0	0	0	0	0	0	2
OG0010666	2	0	0	0	0	0	0	2
OG0010667	2	0	0	0	0	0	0	2
OG0010668	2	0	0	0	0	0	0	2
OG0010669	2	0	0	0	0	0	0	2
OG0010670	1	0	1	0	0	0	0	2
OG0010671	2	0	0	0	0	0	0	2
OG0010672	2	0	0	0	0	0	0	2
OG0010673	2	0	0	0	0	0	0	2
OG0010674	2	0	0	0	0	0	0	2
OG0010675	2	0	0	0	0	0	0	2
OG0010676	2	0	0	0	0	0	0	2
OG0010677	2	0	0	0	0	0	0	2
OG0010678	2	0	0	0	0	0	0	2
OG0010679	2	0	0	0	0	0	0	2
OG0010680	2	0	0	0	0	0	0	2
OG0010681	2	0	0	0	0	0	0	2
OG0010682	2	0	0	0	0	0	0	2
OG0010683	2	0	0	0	0	0	0	2
OG0010684	2	0	0	0	0	0	0	2
OG0010685	2	0	0	0	0	0	0	2
OG0010686	1	0	1	0	0	0	0	2
OG0010687	2	0	0	0	0	0	0	2
OG0010688	2	0	0	0	0	0	0	2
OG0010689	2	0	0	0	0	0	0	2
OG0010690	2	0	0	0	0	0	0	2
OG0010691	2	0	0	0	0	0	0	2
OG0010692	1	0	0	0	0	1	0	2
OG0010693	2	0	0	0	0	0	0	2
OG0010694	2	0	0	0	0	0	0	2
OG0010695	2	0	0	0	0	0	0	2
OG0010696	2	0	0	0	0	0	0	2
OG0010697	2	0	0	0	0	0	0	2
OG0010698	2	0	0	0	0	0	0	2
OG0010699	2	0	0	0	0	0	0	2
OG0010700	2	0	0	0	0	0	0	2
OG0010701	2	0	0	0	0	0	0	2
OG0010702	2	0	0	0	0	0	0	2
OG0010703	2	0	0	0	0	0	0	2
OG0010704	2	0	0	0	0	0	0	2
OG0010705	2	0	0	0	0	0	0	2
OG0010706	2	0	0	0	0	0	0	2
OG0010707	2	0	0	0	0	0	0	2
OG0010708	2	0	0	0	0	0	0	2
OG0010709	2	0	0	0	0	0	0	2
OG0010710	2	0	0	0	0	0	0	2
OG0010711	2	0	0	0	0	0	0	2
OG0010712	2	0	0	0	0	0	0	2
OG0010713	2	0	0	0	0	0	0	2
OG0010714	2	0	0	0	0	0	0	2
OG0010715	2	0	0	0	0	0	0	2
OG0010716	2	0	0	0	0	0	0	2
OG0010717	2	0	0	0	0	0	0	2
OG0010718	2	0	0	0	0	0	0	2
OG0010719	2	0	0	0	0	0	0	2
OG0010720	2	0	0	0	0	0	0	2
OG0010721	2	0	0	0	0	0	0	2
OG0010722	2	0	0	0	0	0	0	2
OG0010723	2	0	0	0	0	0	0	2
OG0010724	2	0	0	0	0	0	0	2
OG0010725	2	0	0	0	0	0	0	2
OG0010726	1	1	0	0	0	0	0	2
OG0010727	2	0	0	0	0	0	0	2
OG0010728	2	0	0	0	0	0	0	2
OG0010729	2	0	0	0	0	0	0	2
OG0010730	2	0	0	0	0	0	0	2
OG0010731	2	0	0	0	0	0	0	2
OG0010732	2	0	0	0	0	0	0	2
OG0010733	2	0	0	0	0	0	0	2
OG0010734	2	0	0	0	0	0	0	2
OG0010735	2	0	0	0	0	0	0	2
OG0010736	2	0	0	0	0	0	0	2
OG0010737	2	0	0	0	0	0	0	2
OG0010738	2	0	0	0	0	0	0	2
OG0010739	2	0	0	0	0	0	0	2
OG0010740	2	0	0	0	0	0	0	2
OG0010741	2	0	0	0	0	0	0	2
OG0010742	2	0	0	0	0	0	0	2
OG0010743	2	0	0	0	0	0	0	2
OG0010744	2	0	0	0	0	0	0	2
OG0010745	2	0	0	0	0	0	0	2
OG0010746	2	0	0	0	0	0	0	2
OG0010747	2	0	0	0	0	0	0	2
OG0010748	2	0	0	0	0	0	0	2
OG0010749	2	0	0	0	0	0	0	2
OG0010750	2	0	0	0	0	0	0	2
OG0010751	2	0	0	0	0	0	0	2
OG0010752	2	0	0	0	0	0	0	2
OG0010753	2	0	0	0	0	0	0	2
OG0010754	2	0	0	0	0	0	0	2
OG0010755	2	0	0	0	0	0	0	2
OG0010756	2	0	0	0	0	0	0	2
OG0010757	2	0	0	0	0	0	0	2
OG0010758	2	0	0	0	0	0	0	2
OG0010759	1	1	0	0	0	0	0	2
OG0010760	2	0	0	0	0	0	0	2
OG0010761	2	0	0	0	0	0	0	2
OG0010762	2	0	0	0	0	0	0	2
OG0010763	2	0	0	0	0	0	0	2
OG0010764	2	0	0	0	0	0	0	2
OG0010765	2	0	0	0	0	0	0	2
OG0010766	2	0	0	0	0	0	0	2
OG0010767	2	0	0	0	0	0	0	2
OG0010768	2	0	0	0	0	0	0	2
OG0010769	2	0	0	0	0	0	0	2
OG0010770	2	0	0	0	0	0	0	2
OG0010771	2	0	0	0	0	0	0	2
OG0010772	2	0	0	0	0	0	0	2
OG0010773	2	0	0	0	0	0	0	2
OG0010774	2	0	0	0	0	0	0	2
OG0010775	2	0	0	0	0	0	0	2
OG0010776	2	0	0	0	0	0	0	2
OG0010777	2	0	0	0	0	0	0	2
OG0010778	2	0	0	0	0	0	0	2
OG0010779	1	0	0	0	0	1	0	2
OG0010780	2	0	0	0	0	0	0	2
OG0010781	2	0	0	0	0	0	0	2
OG0010782	2	0	0	0	0	0	0	2
OG0010783	1	0	1	0	0	0	0	2
OG0010784	2	0	0	0	0	0	0	2
OG0010785	2	0	0	0	0	0	0	2
OG0010786	2	0	0	0	0	0	0	2
OG0010787	2	0	0	0	0	0	0	2
OG0010788	2	0	0	0	0	0	0	2
OG0010789	2	0	0	0	0	0	0	2
OG0010790	2	0	0	0	0	0	0	2
OG0010791	2	0	0	0	0	0	0	2
OG0010792	2	0	0	0	0	0	0	2
OG0010793	2	0	0	0	0	0	0	2
OG0010794	2	0	0	0	0	0	0	2
OG0010795	2	0	0	0	0	0	0	2
OG0010796	2	0	0	0	0	0	0	2
OG0010797	1	0	0	0	0	0	1	2
OG0010798	2	0	0	0	0	0	0	2
OG0010799	2	0	0	0	0	0	0	2
OG0010800	2	0	0	0	0	0	0	2
OG0010801	2	0	0	0	0	0	0	2
OG0010802	0	2	0	0	0	0	0	2
OG0010803	0	2	0	0	0	0	0	2
OG0010804	0	2	0	0	0	0	0	2
OG0010805	0	2	0	0	0	0	0	2
OG0010806	0	2	0	0	0	0	0	2
OG0010807	0	2	0	0	0	0	0	2
OG0010808	0	2	0	0	0	0	0	2
OG0010809	0	2	0	0	0	0	0	2
OG0010810	0	2	0	0	0	0	0	2
OG0010811	0	2	0	0	0	0	0	2
OG0010812	0	2	0	0	0	0	0	2
OG0010813	0	2	0	0	0	0	0	2
OG0010814	0	2	0	0	0	0	0	2
OG0010815	0	2	0	0	0	0	0	2
OG0010816	0	1	0	1	0	0	0	2
OG0010817	0	2	0	0	0	0	0	2
OG0010818	0	2	0	0	0	0	0	2
OG0010819	0	2	0	0	0	0	0	2
OG0010820	0	2	0	0	0	0	0	2
OG0010821	0	1	0	1	0	0	0	2
OG0010822	0	1	1	0	0	0	0	2
OG0010823	0	2	0	0	0	0	0	2
OG0010824	0	2	0	0	0	0	0	2
OG0010825	0	2	0	0	0	0	0	2
OG0010826	0	2	0	0	0	0	0	2
OG0010827	0	2	0	0	0	0	0	2
OG0010828	0	2	0	0	0	0	0	2
OG0010829	0	1	0	1	0	0	0	2
OG0010830	0	1	0	1	0	0	0	2
OG0010831	0	2	0	0	0	0	0	2
OG0010832	0	2	0	0	0	0	0	2
OG0010833	0	2	0	0	0	0	0	2
OG0010834	0	1	1	0	0	0	0	2
OG0010835	0	2	0	0	0	0	0	2
OG0010836	0	2	0	0	0	0	0	2
OG0010837	0	2	0	0	0	0	0	2
OG0010838	0	2	0	0	0	0	0	2
OG0010839	0	2	0	0	0	0	0	2
OG0010840	0	1	0	0	0	0	1	2
OG0010841	0	1	0	1	0	0	0	2
OG0010842	0	1	0	1	0	0	0	2
OG0010843	0	1	0	1	0	0	0	2
OG0010844	0	1	1	0	0	0	0	2
OG0010845	0	1	0	1	0	0	0	2
OG0010846	0	1	1	0	0	0	0	2
OG0010847	0	1	0	1	0	0	0	2
OG0010848	0	1	0	1	0	0	0	2
OG0010849	0	1	0	1	0	0	0	2
OG0010850	0	2	0	0	0	0	0	2
OG0010851	0	1	0	1	0	0	0	2
OG0010852	0	1	0	1	0	0	0	2
OG0010853	0	2	0	0	0	0	0	2
OG0010854	0	1	1	0	0	0	0	2
OG0010855	0	2	0	0	0	0	0	2
OG0010856	0	2	0	0	0	0	0	2
OG0010857	0	2	0	0	0	0	0	2
OG0010858	0	2	0	0	0	0	0	2
OG0010859	0	1	1	0	0	0	0	2
OG0010860	0	1	1	0	0	0	0	2
OG0010861	0	2	0	0	0	0	0	2
OG0010862	0	1	0	1	0	0	0	2
OG0010863	0	2	0	0	0	0	0	2
OG0010864	0	2	0	0	0	0	0	2
OG0010865	0	2	0	0	0	0	0	2
OG0010866	0	2	0	0	0	0	0	2
OG0010867	0	1	0	1	0	0	0	2
OG0010868	0	2	0	0	0	0	0	2
OG0010869	0	2	0	0	0	0	0	2
OG0010870	0	1	1	0	0	0	0	2
OG0010871	0	1	0	1	0	0	0	2
OG0010872	0	1	0	1	0	0	0	2
OG0010873	0	1	0	1	0	0	0	2
OG0010874	0	1	1	0	0	0	0	2
OG0010875	0	2	0	0	0	0	0	2
OG0010876	0	2	0	0	0	0	0	2
OG0010877	0	1	1	0	0	0	0	2
OG0010878	0	2	0	0	0	0	0	2
OG0010879	0	2	0	0	0	0	0	2
OG0010880	0	2	0	0	0	0	0	2
OG0010881	0	2	0	0	0	0	0	2
OG0010882	0	2	0	0	0	0	0	2
OG0010883	0	2	0	0	0	0	0	2
OG0010884	0	2	0	0	0	0	0	2
OG0010885	0	1	1	0	0	0	0	2
OG0010886	0	2	0	0	0	0	0	2
OG0010887	0	2	0	0	0	0	0	2
OG0010888	0	1	0	1	0	0	0	2
OG0010889	0	1	1	0	0	0	0	2
OG0010890	0	1	1	0	0	0	0	2
OG0010891	0	1	1	0	0	0	0	2
OG0010892	0	2	0	0	0	0	0	2
OG0010893	0	2	0	0	0	0	0	2
OG0010894	0	2	0	0	0	0	0	2
OG0010895	0	2	0	0	0	0	0	2
OG0010896	0	1	1	0	0	0	0	2
OG0010897	0	2	0	0	0	0	0	2
OG0010898	0	1	0	1	0	0	0	2
OG0010899	0	2	0	0	0	0	0	2
OG0010900	0	1	1	0	0	0	0	2
OG0010901	0	1	0	1	0	0	0	2
OG0010902	0	1	0	1	0	0	0	2
OG0010903	0	1	0	1	0	0	0	2
OG0010904	0	2	0	0	0	0	0	2
OG0010905	0	2	0	0	0	0	0	2
OG0010906	0	2	0	0	0	0	0	2
OG0010907	0	2	0	0	0	0	0	2
OG0010908	0	2	0	0	0	0	0	2
OG0010909	0	1	0	1	0	0	0	2
OG0010910	0	1	0	1	0	0	0	2
OG0010911	0	1	1	0	0	0	0	2
OG0010912	0	1	0	1	0	0	0	2
OG0010913	0	1	1	0	0	0	0	2
OG0010914	0	1	0	1	0	0	0	2
OG0010915	0	2	0	0	0	0	0	2
OG0010916	0	1	0	1	0	0	0	2
OG0010917	0	1	0	1	0	0	0	2
OG0010918	0	2	0	0	0	0	0	2
OG0010919	0	1	1	0	0	0	0	2
OG0010920	0	1	1	0	0	0	0	2
OG0010921	0	1	1	0	0	0	0	2
OG0010922	0	2	0	0	0	0	0	2
OG0010923	0	1	0	1	0	0	0	2
OG0010924	0	2	0	0	0	0	0	2
OG0010925	0	1	0	1	0	0	0	2
OG0010926	0	2	0	0	0	0	0	2
OG0010927	0	2	0	0	0	0	0	2
OG0010928	0	1	1	0	0	0	0	2
OG0010929	0	1	0	1	0	0	0	2
OG0010930	0	2	0	0	0	0	0	2
OG0010931	0	2	0	0	0	0	0	2
OG0010932	0	1	0	1	0	0	0	2
OG0010933	0	1	1	0	0	0	0	2
OG0010934	0	2	0	0	0	0	0	2
OG0010935	0	1	1	0	0	0	0	2
OG0010936	0	2	0	0	0	0	0	2
OG0010937	0	1	1	0	0	0	0	2
OG0010938	0	2	0	0	0	0	0	2
OG0010939	0	2	0	0	0	0	0	2
OG0010940	0	1	1	0	0	0	0	2
OG0010941	0	2	0	0	0	0	0	2
OG0010942	0	1	0	1	0	0	0	2
OG0010943	0	1	0	1	0	0	0	2
OG0010944	0	2	0	0	0	0	0	2
OG0010945	0	2	0	0	0	0	0	2
OG0010946	0	1	1	0	0	0	0	2
OG0010947	0	2	0	0	0	0	0	2
OG0010948	0	2	0	0	0	0	0	2
OG0010949	0	2	0	0	0	0	0	2
OG0010950	0	2	0	0	0	0	0	2
OG0010951	0	1	1	0	0	0	0	2
OG0010952	0	1	1	0	0	0	0	2
OG0010953	0	1	0	1	0	0	0	2
OG0010954	0	1	0	1	0	0	0	2
OG0010955	0	1	1	0	0	0	0	2
OG0010956	0	2	0	0	0	0	0	2
OG0010957	0	2	0	0	0	0	0	2
OG0010958	0	1	0	0	0	1	0	2
OG0010959	0	2	0	0	0	0	0	2
OG0010960	0	1	1	0	0	0	0	2
OG0010961	0	1	0	1	0	0	0	2
OG0010962	0	1	1	0	0	0	0	2
OG0010963	0	1	0	1	0	0	0	2
OG0010964	0	1	1	0	0	0	0	2
OG0010965	0	1	1	0	0	0	0	2
OG0010966	0	2	0	0	0	0	0	2
OG0010967	0	1	1	0	0	0	0	2
OG0010968	0	1	0	1	0	0	0	2
OG0010969	0	0	2	0	0	0	0	2
OG0010970	0	0	1	0	0	0	1	2
OG0010971	0	0	1	1	0	0	0	2
OG0010972	0	0	2	0	0	0	0	2
OG0010973	0	0	2	0	0	0	0	2
OG0010974	0	0	2	0	0	0	0	2
OG0010975	0	0	2	0	0	0	0	2
OG0010976	0	0	1	1	0	0	0	2
OG0010977	0	0	2	0	0	0	0	2
OG0010978	0	0	2	0	0	0	0	2
OG0010979	0	0	2	0	0	0	0	2
OG0010980	0	0	1	1	0	0	0	2
OG0010981	0	0	2	0	0	0	0	2
OG0010982	0	0	2	0	0	0	0	2
OG0010983	0	0	1	0	0	1	0	2
OG0010984	0	0	1	1	0	0	0	2
OG0010985	0	0	2	0	0	0	0	2
OG0010986	0	0	2	0	0	0	0	2
OG0010987	0	0	1	1	0	0	0	2
OG0010988	0	0	1	0	0	1	0	2
OG0010989	0	0	2	0	0	0	0	2
OG0010990	0	0	1	0	0	1	0	2
OG0010991	0	0	1	1	0	0	0	2
OG0010992	0	0	2	0	0	0	0	2
OG0010993	0	0	2	0	0	0	0	2
OG0010994	0	0	2	0	0	0	0	2
OG0010995	0	0	1	1	0	0	0	2
OG0010996	0	0	1	1	0	0	0	2
OG0010997	0	0	1	1	0	0	0	2
OG0010998	0	0	1	1	0	0	0	2
OG0010999	0	0	2	0	0	0	0	2
OG0011000	0	0	1	1	0	0	0	2
OG0011001	0	0	1	1	0	0	0	2
OG0011002	0	0	2	0	0	0	0	2
OG0011003	0	0	2	0	0	0	0	2
OG0011004	0	0	2	0	0	0	0	2
OG0011005	0	0	2	0	0	0	0	2
OG0011006	0	0	2	0	0	0	0	2
OG0011007	0	0	2	0	0	0	0	2
OG0011008	0	0	2	0	0	0	0	2
OG0011009	0	0	1	1	0	0	0	2
OG0011010	0	0	1	0	0	1	0	2
OG0011011	0	0	1	1	0	0	0	2
OG0011012	0	0	2	0	0	0	0	2
OG0011013	0	0	1	1	0	0	0	2
OG0011014	0	0	2	0	0	0	0	2
OG0011015	0	0	2	0	0	0	0	2
OG0011016	0	0	2	0	0	0	0	2
OG0011017	0	0	2	0	0	0	0	2
OG0011018	0	0	2	0	0	0	0	2
OG0011019	0	0	2	0	0	0	0	2
OG0011020	0	0	1	1	0	0	0	2
OG0011021	0	0	2	0	0	0	0	2
OG0011022	0	0	2	0	0	0	0	2
OG0011023	0	0	1	1	0	0	0	2
OG0011024	0	0	1	1	0	0	0	2
OG0011025	0	0	2	0	0	0	0	2
OG0011026	0	0	2	0	0	0	0	2
OG0011027	0	0	2	0	0	0	0	2
OG0011028	0	0	2	0	0	0	0	2
OG0011029	0	0	1	1	0	0	0	2
OG0011030	0	0	2	0	0	0	0	2
OG0011031	0	0	2	0	0	0	0	2
OG0011032	0	0	2	0	0	0	0	2
OG0011033	0	0	2	0	0	0	0	2
OG0011034	0	0	2	0	0	0	0	2
OG0011035	0	0	2	0	0	0	0	2
OG0011036	0	0	2	0	0	0	0	2
OG0011037	0	0	2	0	0	0	0	2
OG0011038	0	0	2	0	0	0	0	2
OG0011039	0	0	1	0	0	1	0	2
OG0011040	0	0	2	0	0	0	0	2
OG0011041	0	0	2	0	0	0	0	2
OG0011042	0	0	2	0	0	0	0	2
OG0011043	0	0	1	1	0	0	0	2
OG0011044	0	0	1	1	0	0	0	2
OG0011045	0	0	1	1	0	0	0	2
OG0011046	0	0	1	1	0	0	0	2
OG0011047	0	0	2	0	0	0	0	2
OG0011048	0	0	2	0	0	0	0	2
OG0011049	0	0	1	1	0	0	0	2
OG0011050	0	0	2	0	0	0	0	2
OG0011051	0	0	1	0	0	1	0	2
OG0011052	0	0	2	0	0	0	0	2
OG0011053	0	0	1	0	0	1	0	2
OG0011054	0	0	1	0	0	1	0	2
OG0011055	0	0	1	1	0	0	0	2
OG0011056	0	0	2	0	0	0	0	2
OG0011057	0	0	2	0	0	0	0	2
OG0011058	0	0	2	0	0	0	0	2
OG0011059	0	0	2	0	0	0	0	2
OG0011060	0	0	1	1	0	0	0	2
OG0011061	0	0	1	1	0	0	0	2
OG0011062	0	0	2	0	0	0	0	2
OG0011063	0	0	2	0	0	0	0	2
OG0011064	0	0	1	1	0	0	0	2
OG0011065	0	0	1	1	0	0	0	2
OG0011066	0	0	2	0	0	0	0	2
OG0011067	0	0	2	0	0	0	0	2
OG0011068	0	0	1	1	0	0	0	2
OG0011069	0	0	1	0	0	1	0	2
OG0011070	0	0	1	1	0	0	0	2
OG0011071	0	0	1	1	0	0	0	2
OG0011072	0	0	2	0	0	0	0	2
OG0011073	0	0	2	0	0	0	0	2
OG0011074	0	0	1	0	0	1	0	2
OG0011075	0	0	1	1	0	0	0	2
OG0011076	0	0	2	0	0	0	0	2
OG0011077	0	0	1	1	0	0	0	2
OG0011078	0	0	2	0	0	0	0	2
OG0011079	0	0	1	1	0	0	0	2
OG0011080	0	0	2	0	0	0	0	2
OG0011081	0	0	2	0	0	0	0	2
OG0011082	0	0	2	0	0	0	0	2
OG0011083	0	0	2	0	0	0	0	2
OG0011084	0	0	1	1	0	0	0	2
OG0011085	0	0	1	1	0	0	0	2
OG0011086	0	0	2	0	0	0	0	2
OG0011087	0	0	2	0	0	0	0	2
OG0011088	0	0	2	0	0	0	0	2
OG0011089	0	0	1	0	0	1	0	2
OG0011090	0	0	1	1	0	0	0	2
OG0011091	0	0	2	0	0	0	0	2
OG0011092	0	0	1	1	0	0	0	2
OG0011093	0	0	2	0	0	0	0	2
OG0011094	0	0	2	0	0	0	0	2
OG0011095	0	0	1	1	0	0	0	2
OG0011096	0	0	2	0	0	0	0	2
OG0011097	0	0	2	0	0	0	0	2
OG0011098	0	0	2	0	0	0	0	2
OG0011099	0	0	1	1	0	0	0	2
OG0011100	0	0	1	0	0	1	0	2
OG0011101	0	0	2	0	0	0	0	2
OG0011102	0	0	1	1	0	0	0	2
OG0011103	0	0	2	0	0	0	0	2
OG0011104	0	0	2	0	0	0	0	2
OG0011105	0	0	2	0	0	0	0	2
OG0011106	0	0	2	0	0	0	0	2
OG0011107	0	0	2	0	0	0	0	2
OG0011108	0	0	2	0	0	0	0	2
OG0011109	0	0	1	0	0	1	0	2
OG0011110	0	0	2	0	0	0	0	2
OG0011111	0	0	2	0	0	0	0	2
OG0011112	0	0	2	0	0	0	0	2
OG0011113	0	0	2	0	0	0	0	2
OG0011114	0	0	2	0	0	0	0	2
OG0011115	0	0	2	0	0	0	0	2
OG0011116	0	0	2	0	0	0	0	2
OG0011117	0	0	2	0	0	0	0	2
OG0011118	0	0	2	0	0	0	0	2
OG0011119	0	0	2	0	0	0	0	2
OG0011120	0	0	2	0	0	0	0	2
OG0011121	0	0	2	0	0	0	0	2
OG0011122	0	0	2	0	0	0	0	2
OG0011123	0	0	1	1	0	0	0	2
OG0011124	0	0	2	0	0	0	0	2
OG0011125	0	0	2	0	0	0	0	2
OG0011126	0	0	2	0	0	0	0	2
OG0011127	0	0	2	0	0	0	0	2
OG0011128	0	0	1	0	0	1	0	2
OG0011129	0	0	2	0	0	0	0	2
OG0011130	0	0	2	0	0	0	0	2
OG0011131	0	0	2	0	0	0	0	2
OG0011132	0	0	1	1	0	0	0	2
OG0011133	0	0	1	1	0	0	0	2
OG0011134	0	0	1	1	0	0	0	2
OG0011135	0	0	2	0	0	0	0	2
OG0011136	0	0	1	0	0	1	0	2
OG0011137	0	0	2	0	0	0	0	2
OG0011138	0	0	2	0	0	0	0	2
OG0011139	0	0	1	0	0	1	0	2
OG0011140	0	0	2	0	0	0	0	2
OG0011141	0	0	2	0	0	0	0	2
OG0011142	0	0	1	1	0	0	0	2
OG0011143	0	0	2	0	0	0	0	2
OG0011144	0	0	2	0	0	0	0	2
OG0011145	0	0	2	0	0	0	0	2
OG0011146	0	0	2	0	0	0	0	2
OG0011147	0	0	2	0	0	0	0	2
OG0011148	0	0	2	0	0	0	0	2
OG0011149	0	0	2	0	0	0	0	2
OG0011150	0	0	2	0	0	0	0	2
OG0011151	0	0	2	0	0	0	0	2
OG0011152	0	0	2	0	0	0	0	2
OG0011153	0	0	2	0	0	0	0	2
OG0011154	0	0	2	0	0	0	0	2
OG0011155	0	0	1	1	0	0	0	2
OG0011156	0	0	1	0	0	1	0	2
OG0011157	0	0	1	1	0	0	0	2
OG0011158	0	0	2	0	0	0	0	2
OG0011159	0	0	2	0	0	0	0	2
OG0011160	0	0	2	0	0	0	0	2
OG0011161	0	0	2	0	0	0	0	2
OG0011162	0	0	1	0	0	1	0	2
OG0011163	0	0	2	0	0	0	0	2
OG0011164	0	0	2	0	0	0	0	2
OG0011165	0	0	1	1	0	0	0	2
OG0011166	0	0	1	0	0	1	0	2
OG0011167	0	0	2	0	0	0	0	2
OG0011168	0	0	1	1	0	0	0	2
OG0011169	0	0	2	0	0	0	0	2
OG0011170	0	0	1	1	0	0	0	2
OG0011171	0	0	2	0	0	0	0	2
OG0011172	0	0	2	0	0	0	0	2
OG0011173	0	0	2	0	0	0	0	2
OG0011174	0	0	0	2	0	0	0	2
OG0011175	0	0	0	2	0	0	0	2
OG0011176	0	0	0	2	0	0	0	2
OG0011177	0	0	0	2	0	0	0	2
OG0011178	0	0	0	2	0	0	0	2
OG0011179	0	0	0	2	0	0	0	2
OG0011180	0	0	0	2	0	0	0	2
OG0011181	0	0	0	2	0	0	0	2
OG0011182	0	0	0	2	0	0	0	2
OG0011183	0	0	0	2	0	0	0	2
OG0011184	0	0	0	1	0	1	0	2
OG0011185	0	0	0	2	0	0	0	2
OG0011186	0	0	0	2	0	0	0	2
OG0011187	0	0	0	2	0	0	0	2
OG0011188	0	0	0	2	0	0	0	2
OG0011189	0	0	0	2	0	0	0	2
OG0011190	0	0	0	2	0	0	0	2
OG0011191	0	0	0	2	0	0	0	2
OG0011192	0	0	0	2	0	0	0	2
OG0011193	0	0	0	2	0	0	0	2
OG0011194	0	0	0	2	0	0	0	2
OG0011195	0	0	0	2	0	0	0	2
OG0011196	0	0	0	2	0	0	0	2
OG0011197	0	0	0	2	0	0	0	2
OG0011198	0	0	0	2	0	0	0	2
OG0011199	0	0	0	2	0	0	0	2
OG0011200	0	0	0	2	0	0	0	2
OG0011201	0	0	0	2	0	0	0	2
OG0011202	0	0	0	2	0	0	0	2
OG0011203	0	0	0	2	0	0	0	2
OG0011204	0	0	0	2	0	0	0	2
OG0011205	0	0	0	2	0	0	0	2
OG0011206	0	0	0	2	0	0	0	2
OG0011207	0	0	0	2	0	0	0	2
OG0011208	0	0	0	2	0	0	0	2
OG0011209	0	0	0	2	0	0	0	2
OG0011210	0	0	0	2	0	0	0	2
OG0011211	0	0	0	2	0	0	0	2
OG0011212	0	0	0	2	0	0	0	2
OG0011213	0	0	0	2	0	0	0	2
OG0011214	0	0	0	2	0	0	0	2
OG0011215	0	0	0	2	0	0	0	2
OG0011216	0	0	0	2	0	0	0	2
OG0011217	0	0	0	2	0	0	0	2
OG0011218	0	0	0	2	0	0	0	2
OG0011219	0	0	0	2	0	0	0	2
OG0011220	0	0	0	2	0	0	0	2
OG0011221	0	0	0	2	0	0	0	2
OG0011222	0	0	0	2	0	0	0	2
OG0011223	0	0	0	2	0	0	0	2
OG0011224	0	0	0	2	0	0	0	2
OG0011225	0	0	0	2	0	0	0	2
OG0011226	0	0	0	2	0	0	0	2
OG0011227	0	0	0	2	0	0	0	2
OG0011228	0	0	0	2	0	0	0	2
OG0011229	0	0	0	2	0	0	0	2
OG0011230	0	0	0	2	0	0	0	2
OG0011231	0	0	0	2	0	0	0	2
OG0011232	0	0	0	2	0	0	0	2
OG0011233	0	0	0	1	1	0	0	2
OG0011234	0	0	0	2	0	0	0	2
OG0011235	0	0	0	2	0	0	0	2
OG0011236	0	0	0	2	0	0	0	2
OG0011237	0	0	0	2	0	0	0	2
OG0011238	0	0	0	2	0	0	0	2
OG0011239	0	0	0	2	0	0	0	2
OG0011240	0	0	0	2	0	0	0	2
OG0011241	0	0	0	2	0	0	0	2
OG0011242	0	0	0	2	0	0	0	2
OG0011243	0	0	0	2	0	0	0	2
OG0011244	0	0	0	2	0	0	0	2
OG0011245	0	0	0	2	0	0	0	2
OG0011246	0	0	0	2	0	0	0	2
OG0011247	0	0	0	2	0	0	0	2
OG0011248	0	0	0	2	0	0	0	2
OG0011249	0	0	0	2	0	0	0	2
OG0011250	0	0	0	2	0	0	0	2
OG0011251	0	0	0	2	0	0	0	2
OG0011252	0	0	0	2	0	0	0	2
OG0011253	0	0	0	2	0	0	0	2
OG0011254	0	0	0	2	0	0	0	2
OG0011255	0	0	0	2	0	0	0	2
OG0011256	0	0	0	2	0	0	0	2
OG0011257	0	0	0	2	0	0	0	2
OG0011258	0	0	0	2	0	0	0	2
OG0011259	0	0	0	2	0	0	0	2
OG0011260	0	0	0	2	0	0	0	2
OG0011261	0	0	0	2	0	0	0	2
OG0011262	0	0	0	2	0	0	0	2
OG0011263	0	0	0	2	0	0	0	2
OG0011264	0	0	0	2	0	0	0	2
OG0011265	0	0	0	2	0	0	0	2
OG0011266	0	0	0	2	0	0	0	2
OG0011267	0	0	0	2	0	0	0	2
OG0011268	0	0	0	2	0	0	0	2
OG0011269	0	0	0	2	0	0	0	2
OG0011270	0	0	0	2	0	0	0	2
OG0011271	0	0	0	2	0	0	0	2
OG0011272	0	0	0	2	0	0	0	2
OG0011273	0	0	0	2	0	0	0	2
OG0011274	0	0	0	2	0	0	0	2
OG0011275	0	0	0	2	0	0	0	2
OG0011276	0	0	0	2	0	0	0	2
OG0011277	0	0	0	2	0	0	0	2
OG0011278	0	0	0	2	0	0	0	2
OG0011279	0	0	0	2	0	0	0	2
OG0011280	0	0	0	2	0	0	0	2
OG0011281	0	0	0	2	0	0	0	2
OG0011282	0	0	0	2	0	0	0	2
OG0011283	0	0	0	2	0	0	0	2
OG0011284	0	0	0	2	0	0	0	2
OG0011285	0	0	0	2	0	0	0	2
OG0011286	0	0	0	2	0	0	0	2
OG0011287	0	0	0	2	0	0	0	2
OG0011288	0	0	0	2	0	0	0	2
OG0011289	0	0	0	2	0	0	0	2
OG0011290	0	0	0	2	0	0	0	2
OG0011291	0	0	0	2	0	0	0	2
OG0011292	0	0	0	2	0	0	0	2
OG0011293	0	0	0	2	0	0	0	2
OG0011294	0	0	0	2	0	0	0	2
OG0011295	0	0	0	2	0	0	0	2
OG0011296	0	0	0	2	0	0	0	2
OG0011297	0	0	0	2	0	0	0	2
OG0011298	0	0	0	2	0	0	0	2
OG0011299	0	0	0	2	0	0	0	2
OG0011300	0	0	0	2	0	0	0	2
OG0011301	0	0	0	2	0	0	0	2
OG0011302	0	0	0	2	0	0	0	2
OG0011303	0	0	0	2	0	0	0	2
OG0011304	0	0	0	2	0	0	0	2
OG0011305	0	0	0	2	0	0	0	2
OG0011306	0	0	0	2	0	0	0	2
OG0011307	0	0	0	2	0	0	0	2
OG0011308	0	0	0	2	0	0	0	2
OG0011309	0	0	0	2	0	0	0	2
OG0011310	0	0	0	2	0	0	0	2
OG0011311	0	0	0	2	0	0	0	2
OG0011312	0	0	0	2	0	0	0	2
OG0011313	0	0	0	2	0	0	0	2
OG0011314	0	0	0	2	0	0	0	2
OG0011315	0	0	0	2	0	0	0	2
OG0011316	0	0	0	2	0	0	0	2
OG0011317	0	0	0	2	0	0	0	2
OG0011318	0	0	0	2	0	0	0	2
OG0011319	0	0	0	2	0	0	0	2
OG0011320	0	0	0	1	0	1	0	2
OG0011321	0	0	0	2	0	0	0	2
OG0011322	0	0	0	2	0	0	0	2
OG0011323	0	0	0	2	0	0	0	2
OG0011324	0	0	0	2	0	0	0	2
OG0011325	0	0	0	2	0	0	0	2
OG0011326	0	0	0	2	0	0	0	2
OG0011327	0	0	0	2	0	0	0	2
OG0011328	0	0	0	2	0	0	0	2
OG0011329	0	0	0	2	0	0	0	2
OG0011330	0	0	0	2	0	0	0	2
OG0011331	0	0	0	2	0	0	0	2
OG0011332	0	0	0	2	0	0	0	2
OG0011333	0	0	0	2	0	0	0	2
OG0011334	0	0	0	2	0	0	0	2
OG0011335	0	0	0	2	0	0	0	2
OG0011336	0	0	0	2	0	0	0	2
OG0011337	0	0	0	2	0	0	0	2
OG0011338	0	0	0	2	0	0	0	2
OG0011339	0	0	0	2	0	0	0	2
OG0011340	0	0	0	2	0	0	0	2
OG0011341	0	0	0	2	0	0	0	2
OG0011342	0	0	0	2	0	0	0	2
OG0011343	0	0	0	2	0	0	0	2
OG0011344	0	0	0	2	0	0	0	2
OG0011345	0	0	0	2	0	0	0	2
OG0011346	0	0	0	2	0	0	0	2
OG0011347	0	0	0	2	0	0	0	2
OG0011348	0	0	0	2	0	0	0	2
OG0011349	0	0	0	2	0	0	0	2
OG0011350	0	0	0	2	0	0	0	2
OG0011351	0	0	0	2	0	0	0	2
OG0011352	0	0	0	2	0	0	0	2
OG0011353	0	0	0	2	0	0	0	2
OG0011354	0	0	0	2	0	0	0	2
OG0011355	0	0	0	2	0	0	0	2
OG0011356	0	0	0	2	0	0	0	2
OG0011357	0	0	0	2	0	0	0	2
OG0011358	0	0	0	2	0	0	0	2
OG0011359	0	0	0	2	0	0	0	2
OG0011360	0	0	0	2	0	0	0	2
OG0011361	0	0	0	2	0	0	0	2
OG0011362	0	0	0	2	0	0	0	2
OG0011363	0	0	0	2	0	0	0	2
OG0011364	0	0	0	2	0	0	0	2
OG0011365	0	0	0	2	0	0	0	2
OG0011366	0	0	0	2	0	0	0	2
OG0011367	0	0	0	2	0	0	0	2
OG0011368	0	0	0	2	0	0	0	2
OG0011369	0	0	0	2	0	0	0	2
OG0011370	0	0	0	2	0	0	0	2
OG0011371	0	0	0	2	0	0	0	2
OG0011372	0	0	0	2	0	0	0	2
OG0011373	0	0	0	2	0	0	0	2
OG0011374	0	0	0	2	0	0	0	2
OG0011375	0	0	0	2	0	0	0	2
OG0011376	0	0	0	2	0	0	0	2
OG0011377	0	0	0	2	0	0	0	2
OG0011378	0	0	0	2	0	0	0	2
OG0011379	0	0	0	2	0	0	0	2
OG0011380	0	0	0	2	0	0	0	2
OG0011381	0	0	0	2	0	0	0	2
OG0011382	0	0	0	2	0	0	0	2
OG0011383	0	0	0	2	0	0	0	2
OG0011384	0	0	0	2	0	0	0	2
OG0011385	0	0	0	2	0	0	0	2
OG0011386	0	0	0	2	0	0	0	2
OG0011387	0	0	0	2	0	0	0	2
OG0011388	0	0	0	2	0	0	0	2
OG0011389	0	0	0	2	0	0	0	2
OG0011390	0	0	0	2	0	0	0	2
OG0011391	0	0	0	2	0	0	0	2
OG0011392	0	0	0	2	0	0	0	2
OG0011393	0	0	0	2	0	0	0	2
OG0011394	0	0	0	2	0	0	0	2
OG0011395	0	0	0	2	0	0	0	2
OG0011396	0	0	0	2	0	0	0	2
OG0011397	0	0	0	1	0	1	0	2
OG0011398	0	0	0	2	0	0	0	2
OG0011399	0	0	0	2	0	0	0	2
OG0011400	0	0	0	2	0	0	0	2
OG0011401	0	0	0	2	0	0	0	2
OG0011402	0	0	0	2	0	0	0	2
OG0011403	0	0	0	2	0	0	0	2
OG0011404	0	0	0	2	0	0	0	2
OG0011405	0	0	0	2	0	0	0	2
OG0011406	0	0	0	1	0	1	0	2
OG0011407	0	0	0	2	0	0	0	2
OG0011408	0	0	0	2	0	0	0	2
OG0011409	0	0	0	2	0	0	0	2
OG0011410	0	0	0	2	0	0	0	2
OG0011411	0	0	0	2	0	0	0	2
OG0011412	0	0	0	2	0	0	0	2
OG0011413	0	0	0	2	0	0	0	2
OG0011414	0	0	0	2	0	0	0	2
OG0011415	0	0	0	2	0	0	0	2
OG0011416	0	0	0	2	0	0	0	2
OG0011417	0	0	0	2	0	0	0	2
OG0011418	0	0	0	2	0	0	0	2
OG0011419	0	0	0	2	0	0	0	2
OG0011420	0	0	0	2	0	0	0	2
OG0011421	0	0	0	2	0	0	0	2
OG0011422	0	0	0	2	0	0	0	2
OG0011423	0	0	0	2	0	0	0	2
OG0011424	0	0	0	2	0	0	0	2
OG0011425	0	0	0	2	0	0	0	2
OG0011426	0	0	0	2	0	0	0	2
OG0011427	0	0	0	2	0	0	0	2
OG0011428	0	0	0	2	0	0	0	2
OG0011429	0	0	0	2	0	0	0	2
OG0011430	0	0	0	2	0	0	0	2
OG0011431	0	0	0	2	0	0	0	2
OG0011432	0	0	0	2	0	0	0	2
OG0011433	0	0	0	2	0	0	0	2
OG0011434	0	0	0	2	0	0	0	2
OG0011435	0	0	0	2	0	0	0	2
OG0011436	0	0	0	2	0	0	0	2
OG0011437	0	0	0	2	0	0	0	2
OG0011438	0	0	0	2	0	0	0	2
OG0011439	0	0	0	2	0	0	0	2
OG0011440	0	0	0	2	0	0	0	2
OG0011441	0	0	0	1	0	0	1	2
OG0011442	0	0	0	2	0	0	0	2
OG0011443	0	0	0	2	0	0	0	2
OG0011444	0	0	0	2	0	0	0	2
OG0011445	0	0	0	2	0	0	0	2
OG0011446	0	0	0	2	0	0	0	2
OG0011447	0	0	0	2	0	0	0	2
OG0011448	0	0	0	2	0	0	0	2
OG0011449	0	0	0	2	0	0	0	2
OG0011450	0	0	0	2	0	0	0	2
OG0011451	0	0	0	2	0	0	0	2
OG0011452	0	0	0	2	0	0	0	2
OG0011453	0	0	0	1	1	0	0	2
OG0011454	0	0	0	2	0	0	0	2
OG0011455	0	0	0	2	0	0	0	2
OG0011456	0	0	0	2	0	0	0	2
OG0011457	0	0	0	2	0	0	0	2
OG0011458	0	0	0	2	0	0	0	2
OG0011459	0	0	0	2	0	0	0	2
OG0011460	0	0	0	2	0	0	0	2
OG0011461	0	0	0	2	0	0	0	2
OG0011462	0	0	0	1	0	1	0	2
OG0011463	0	0	0	2	0	0	0	2
OG0011464	0	0	0	2	0	0	0	2
OG0011465	0	0	0	2	0	0	0	2
OG0011466	0	0	0	2	0	0	0	2
OG0011467	0	0	0	2	0	0	0	2
OG0011468	0	0	0	2	0	0	0	2
OG0011469	0	0	0	2	0	0	0	2
OG0011470	0	0	0	2	0	0	0	2
OG0011471	0	0	0	2	0	0	0	2
OG0011472	0	0	0	2	0	0	0	2
OG0011473	0	0	0	2	0	0	0	2
OG0011474	0	0	0	2	0	0	0	2
OG0011475	0	0	0	2	0	0	0	2
OG0011476	0	0	0	2	0	0	0	2
OG0011477	0	0	0	2	0	0	0	2
OG0011478	0	0	0	2	0	0	0	2
OG0011479	0	0	0	2	0	0	0	2
OG0011480	0	0	0	2	0	0	0	2
OG0011481	0	0	0	2	0	0	0	2
OG0011482	0	0	0	2	0	0	0	2
OG0011483	0	0	0	2	0	0	0	2
OG0011484	0	0	0	2	0	0	0	2
OG0011485	0	0	0	2	0	0	0	2
OG0011486	0	0	0	2	0	0	0	2
OG0011487	0	0	0	1	0	0	1	2
OG0011488	0	0	0	0	2	0	0	2
OG0011489	0	0	0	0	1	0	1	2
OG0011490	0	0	0	0	2	0	0	2
OG0011491	0	0	0	0	2	0	0	2
OG0011492	0	0	0	0	1	0	1	2
OG0011493	0	0	0	0	2	0	0	2
OG0011494	0	0	0	0	2	0	0	2
OG0011495	0	0	0	0	2	0	0	2
OG0011496	0	0	0	0	2	0	0	2
OG0011497	0	0	0	0	1	0	1	2
OG0011498	0	0	0	0	2	0	0	2
OG0011499	0	0	0	0	2	0	0	2
OG0011500	0	0	0	0	2	0	0	2
OG0011501	0	0	0	0	2	0	0	2
OG0011502	0	0	0	0	1	0	1	2
OG0011503	0	0	0	0	2	0	0	2
OG0011504	0	0	0	0	2	0	0	2
OG0011505	0	0	0	0	2	0	0	2
OG0011506	0	0	0	0	2	0	0	2
OG0011507	0	0	0	0	1	0	1	2
OG0011508	0	0	0	0	1	0	1	2
OG0011509	0	0	0	0	2	0	0	2
OG0011510	0	0	0	0	1	0	1	2
OG0011511	0	0	0	0	1	0	1	2
OG0011512	0	0	0	0	2	0	0	2
OG0011513	0	0	0	0	1	0	1	2
OG0011514	0	0	0	0	1	0	1	2
OG0011515	0	0	0	0	1	0	1	2
OG0011516	0	0	0	0	2	0	0	2
OG0011517	0	0	0	0	2	0	0	2
OG0011518	0	0	0	0	1	0	1	2
OG0011519	0	0	0	0	1	0	1	2
OG0011520	0	0	0	0	1	0	1	2
OG0011521	0	0	0	0	1	0	1	2
OG0011522	0	0	0	0	2	0	0	2
OG0011523	0	0	0	0	1	0	1	2
OG0011524	0	0	0	0	2	0	0	2
OG0011525	0	0	0	0	2	0	0	2
OG0011526	0	0	0	0	2	0	0	2
OG0011527	0	0	0	0	2	0	0	2
OG0011528	0	0	0	0	1	0	1	2
OG0011529	0	0	0	0	2	0	0	2
OG0011530	0	0	0	0	2	0	0	2
OG0011531	0	0	0	0	1	0	1	2
OG0011532	0	0	0	0	2	0	0	2
OG0011533	0	0	0	0	2	0	0	2
OG0011534	0	0	0	0	1	0	1	2
OG0011535	0	0	0	0	2	0	0	2
OG0011536	0	0	0	0	2	0	0	2
OG0011537	0	0	0	0	2	0	0	2
OG0011538	0	0	0	0	1	0	1	2
OG0011539	0	0	0	0	2	0	0	2
OG0011540	0	0	0	0	1	0	1	2
OG0011541	0	0	0	0	2	0	0	2
OG0011542	0	0	0	0	1	0	1	2
OG0011543	0	0	0	0	2	0	0	2
OG0011544	0	0	0	0	1	0	1	2
OG0011545	0	0	0	0	2	0	0	2
OG0011546	0	0	0	0	2	0	0	2
OG0011547	0	0	0	0	1	0	1	2
OG0011548	0	0	0	0	1	0	1	2
OG0011549	0	0	0	0	1	0	1	2
OG0011550	0	0	0	0	2	0	0	2
OG0011551	0	0	0	0	1	0	1	2
OG0011552	0	0	0	0	1	0	1	2
OG0011553	0	0	0	0	2	0	0	2
OG0011554	0	0	0	0	2	0	0	2
OG0011555	0	0	0	0	2	0	0	2
OG0011556	0	0	0	0	2	0	0	2
OG0011557	0	0	0	0	2	0	0	2
OG0011558	0	0	0	0	2	0	0	2
OG0011559	0	0	0	0	2	0	0	2
OG0011560	0	0	0	0	1	0	1	2
OG0011561	0	0	0	0	1	0	1	2
OG0011562	0	0	0	0	1	0	1	2
OG0011563	0	0	0	0	1	0	1	2
OG0011564	0	0	0	0	2	0	0	2
OG0011565	0	0	0	0	1	0	1	2
OG0011566	0	0	0	0	1	0	1	2
OG0011567	0	0	0	0	1	0	1	2
OG0011568	0	0	0	0	2	0	0	2
OG0011569	0	0	0	0	1	0	1	2
OG0011570	0	0	0	0	1	0	1	2
OG0011571	0	0	0	0	1	0	1	2
OG0011572	0	0	0	0	1	0	1	2
OG0011573	0	0	0	0	1	0	1	2
OG0011574	0	0	0	0	1	0	1	2
OG0011575	0	0	0	0	2	0	0	2
OG0011576	0	0	0	0	1	0	1	2
OG0011577	0	0	0	0	2	0	0	2
OG0011578	0	0	0	0	1	0	1	2
OG0011579	0	0	0	0	1	0	1	2
OG0011580	0	0	0	0	2	0	0	2
OG0011581	0	0	0	0	2	0	0	2
OG0011582	0	0	0	0	2	0	0	2
OG0011583	0	0	0	0	2	0	0	2
OG0011584	0	0	0	0	1	0	1	2
OG0011585	0	0	0	0	1	0	1	2
OG0011586	0	0	0	0	2	0	0	2
OG0011587	0	0	0	0	2	0	0	2
OG0011588	0	0	0	0	2	0	0	2
OG0011589	0	0	0	0	1	0	1	2
OG0011590	0	0	0	0	2	0	0	2
OG0011591	0	0	0	0	1	0	1	2
OG0011592	0	0	0	0	1	0	1	2
OG0011593	0	0	0	0	2	0	0	2
OG0011594	0	0	0	0	1	0	1	2
OG0011595	0	0	0	0	1	1	0	2
OG0011596	0	0	0	0	2	0	0	2
OG0011597	0	0	0	0	2	0	0	2
OG0011598	0	0	0	0	2	0	0	2
OG0011599	0	0	0	0	2	0	0	2
OG0011600	0	0	0	0	1	0	1	2
OG0011601	0	0	0	0	1	0	1	2
OG0011602	0	0	0	0	1	0	1	2
OG0011603	0	0	0	0	2	0	0	2
OG0011604	0	0	0	0	1	0	1	2
OG0011605	0	0	0	0	2	0	0	2
OG0011606	0	0	0	0	1	0	1	2
OG0011607	0	0	0	0	2	0	0	2
OG0011608	0	0	0	0	2	0	0	2
OG0011609	0	0	0	0	1	0	1	2
OG0011610	0	0	0	0	1	0	1	2
OG0011611	0	0	0	0	1	0	1	2
OG0011612	0	0	0	0	1	0	1	2
OG0011613	0	0	0	0	2	0	0	2
OG0011614	0	0	0	0	1	0	1	2
OG0011615	0	0	0	0	1	0	1	2
OG0011616	0	0	0	0	2	0	0	2
OG0011617	0	0	0	0	1	0	1	2
OG0011618	0	0	0	0	1	0	1	2
OG0011619	0	0	0	0	2	0	0	2
OG0011620	0	0	0	0	1	0	1	2
OG0011621	0	0	0	0	1	0	1	2
OG0011622	0	0	0	0	2	0	0	2
OG0011623	0	0	0	0	1	0	1	2
OG0011624	0	0	0	0	1	0	1	2
OG0011625	0	0	0	0	2	0	0	2
OG0011626	0	0	0	0	1	0	1	2
OG0011627	0	0	0	0	1	0	1	2
OG0011628	0	0	0	0	1	0	1	2
OG0011629	0	0	0	0	2	0	0	2
OG0011630	0	0	0	0	2	0	0	2
OG0011631	0	0	0	0	1	1	0	2
OG0011632	0	0	0	0	1	0	1	2
OG0011633	0	0	0	0	1	0	1	2
OG0011634	0	0	0	0	2	0	0	2
OG0011635	0	0	0	0	1	0	1	2
OG0011636	0	0	0	0	1	0	1	2
OG0011637	0	0	0	0	1	0	1	2
OG0011638	0	0	0	0	1	0	1	2
OG0011639	0	0	0	0	1	0	1	2
OG0011640	0	0	0	0	2	0	0	2
OG0011641	0	0	0	0	1	0	1	2
OG0011642	0	0	0	0	1	0	1	2
OG0011643	0	0	0	0	1	0	1	2
OG0011644	0	0	0	0	1	0	1	2
OG0011645	0	0	0	0	1	0	1	2
OG0011646	0	0	0	0	1	0	1	2
OG0011647	0	0	0	0	1	0	1	2
OG0011648	0	0	0	0	1	0	1	2
OG0011649	0	0	0	0	1	0	1	2
OG0011650	0	0	0	0	1	0	1	2
OG0011651	0	0	0	0	1	0	1	2
OG0011652	0	0	0	0	2	0	0	2
OG0011653	0	0	0	0	2	0	0	2
OG0011654	0	0	0	0	1	0	1	2
OG0011655	0	0	0	0	2	0	0	2
OG0011656	0	0	0	0	1	0	1	2
OG0011657	0	0	0	0	1	0	1	2
OG0011658	0	0	0	0	1	0	1	2
OG0011659	0	0	0	0	1	0	1	2
OG0011660	0	0	0	0	1	0	1	2
OG0011661	0	0	0	0	1	0	1	2
OG0011662	0	0	0	0	1	0	1	2
OG0011663	0	0	0	0	1	0	1	2
OG0011664	0	0	0	0	2	0	0	2
OG0011665	0	0	0	0	1	0	1	2
OG0011666	0	0	0	0	2	0	0	2
OG0011667	0	0	0	0	2	0	0	2
OG0011668	0	0	0	0	2	0	0	2
OG0011669	0	0	0	0	1	0	1	2
OG0011670	0	0	0	0	1	0	1	2
OG0011671	0	0	0	0	2	0	0	2
OG0011672	0	0	0	0	1	0	1	2
OG0011673	0	0	0	0	1	0	1	2
OG0011674	0	0	0	0	2	0	0	2
OG0011675	0	0	0	0	1	0	1	2
OG0011676	0	0	0	0	1	0	1	2
OG0011677	0	0	0	0	2	0	0	2
OG0011678	0	0	0	0	1	0	1	2
OG0011679	0	0	0	0	2	0	0	2
OG0011680	0	0	0	0	2	0	0	2
OG0011681	0	0	0	0	1	0	1	2
OG0011682	0	0	0	0	1	0	1	2
OG0011683	0	0	0	0	2	0	0	2
OG0011684	0	0	0	0	2	0	0	2
OG0011685	0	0	0	0	1	0	1	2
OG0011686	0	0	0	0	2	0	0	2
OG0011687	0	0	0	0	1	0	1	2
OG0011688	0	0	0	0	1	0	1	2
OG0011689	0	0	0	0	1	0	1	2
OG0011690	0	0	0	0	1	0	1	2
OG0011691	0	0	0	0	1	0	1	2
OG0011692	0	0	0	0	2	0	0	2
OG0011693	0	0	0	0	2	0	0	2
OG0011694	0	0	0	0	2	0	0	2
OG0011695	0	0	0	0	1	0	1	2
OG0011696	0	0	0	0	1	0	1	2
OG0011697	0	0	0	0	1	0	1	2
OG0011698	0	0	0	0	1	0	1	2
OG0011699	0	0	0	0	2	0	0	2
OG0011700	0	0	0	0	1	0	1	2
OG0011701	0	0	0	0	1	0	1	2
OG0011702	0	0	0	0	2	0	0	2
OG0011703	0	0	0	0	2	0	0	2
OG0011704	0	0	0	0	2	0	0	2
OG0011705	0	0	0	0	1	0	1	2
OG0011706	0	0	0	0	1	0	1	2
OG0011707	0	0	0	0	1	0	1	2
OG0011708	0	0	0	0	2	0	0	2
OG0011709	0	0	0	0	2	0	0	2
OG0011710	0	0	0	0	2	0	0	2
OG0011711	0	0	0	0	1	0	1	2
OG0011712	0	0	0	0	1	0	1	2
OG0011713	0	0	0	0	2	0	0	2
OG0011714	0	0	0	0	1	0	1	2
OG0011715	0	0	0	0	2	0	0	2
OG0011716	0	0	0	0	2	0	0	2
OG0011717	0	0	0	0	1	0	1	2
OG0011718	0	0	0	0	2	0	0	2
OG0011719	0	0	0	0	1	0	1	2
OG0011720	0	0	0	0	1	0	1	2
OG0011721	0	0	0	0	1	0	1	2
OG0011722	0	0	0	0	1	0	1	2
OG0011723	0	0	0	0	1	0	1	2
OG0011724	0	0	0	0	2	0	0	2
OG0011725	0	0	0	0	1	0	1	2
OG0011726	0	0	0	0	1	0	1	2
OG0011727	0	0	0	0	1	0	1	2
OG0011728	0	0	0	0	1	0	1	2
OG0011729	0	0	0	0	1	0	1	2
OG0011730	0	0	0	0	2	0	0	2
OG0011731	0	0	0	0	1	0	1	2
OG0011732	0	0	0	0	1	0	1	2
OG0011733	0	0	0	0	1	0	1	2
OG0011734	0	0	0	0	2	0	0	2
OG0011735	0	0	0	0	1	0	1	2
OG0011736	0	0	0	0	1	0	1	2
OG0011737	0	0	0	0	1	0	1	2
OG0011738	0	0	0	0	1	0	1	2
OG0011739	0	0	0	0	2	0	0	2
OG0011740	0	0	0	0	2	0	0	2
OG0011741	0	0	0	0	1	0	1	2
OG0011742	0	0	0	0	1	0	1	2
OG0011743	0	0	0	0	1	0	1	2
OG0011744	0	0	0	0	1	0	1	2
OG0011745	0	0	0	0	1	0	1	2
OG0011746	0	0	0	0	1	0	1	2
OG0011747	0	0	0	0	1	0	1	2
OG0011748	0	0	0	0	2	0	0	2
OG0011749	0	0	0	0	2	0	0	2
OG0011750	0	0	0	0	1	0	1	2
OG0011751	0	0	0	0	1	0	1	2
OG0011752	0	0	0	0	1	0	1	2
OG0011753	0	0	0	0	1	0	1	2
OG0011754	0	0	0	0	1	0	1	2
OG0011755	0	0	0	0	1	0	1	2
OG0011756	0	0	0	0	1	0	1	2
OG0011757	0	0	0	0	1	0	1	2
OG0011758	0	0	0	0	1	0	1	2
OG0011759	0	0	0	0	1	0	1	2
OG0011760	0	0	0	0	2	0	0	2
OG0011761	0	0	0	0	1	0	1	2
OG0011762	0	0	0	0	1	0	1	2
OG0011763	0	0	0	0	1	0	1	2
OG0011764	0	0	0	0	1	0	1	2
OG0011765	0	0	0	0	1	0	1	2
OG0011766	0	0	0	0	2	0	0	2
OG0011767	0	0	0	0	1	0	1	2
OG0011768	0	0	0	0	1	0	1	2
OG0011769	0	0	0	0	2	0	0	2
OG0011770	0	0	0	0	2	0	0	2
OG0011771	0	0	0	0	2	0	0	2
OG0011772	0	0	0	0	2	0	0	2
OG0011773	0	0	0	0	2	0	0	2
OG0011774	0	0	0	0	2	0	0	2
OG0011775	0	0	0	0	1	0	1	2
OG0011776	0	0	0	0	1	0	1	2
OG0011777	0	0	0	0	1	0	1	2
OG0011778	0	0	0	0	2	0	0	2
OG0011779	0	0	0	0	1	0	1	2
OG0011780	0	0	0	0	1	0	1	2
OG0011781	0	0	0	0	1	0	1	2
OG0011782	0	0	0	0	1	0	1	2
OG0011783	0	0	0	0	1	0	1	2
OG0011784	0	0	0	0	1	0	1	2
OG0011785	0	0	0	0	1	0	1	2
OG0011786	0	0	0	0	1	0	1	2
OG0011787	0	0	0	0	1	0	1	2
OG0011788	0	0	0	0	1	0	1	2
OG0011789	0	0	0	0	1	0	1	2
OG0011790	0	0	0	0	2	0	0	2
OG0011791	0	0	0	0	1	0	1	2
OG0011792	0	0	0	0	1	0	1	2
OG0011793	0	0	0	0	1	0	1	2
OG0011794	0	0	0	0	1	0	1	2
OG0011795	0	0	0	0	1	0	1	2
OG0011796	0	0	0	0	2	0	0	2
OG0011797	0	0	0	0	1	0	1	2
OG0011798	0	0	0	0	1	1	0	2
OG0011799	0	0	0	0	1	0	1	2
OG0011800	0	0	0	0	1	0	1	2
OG0011801	0	0	0	0	1	0	1	2
OG0011802	0	0	0	0	1	0	1	2
OG0011803	0	0	0	0	2	0	0	2
OG0011804	0	0	0	0	1	0	1	2
OG0011805	0	0	0	0	1	0	1	2
OG0011806	0	0	0	0	1	0	1	2
OG0011807	0	0	0	0	1	0	1	2
OG0011808	0	0	0	0	1	0	1	2
OG0011809	0	0	0	0	2	0	0	2
OG0011810	0	0	0	0	2	0	0	2
OG0011811	0	0	0	0	1	0	1	2
OG0011812	0	0	0	0	1	0	1	2
OG0011813	0	0	0	0	1	0	1	2
OG0011814	0	0	0	0	2	0	0	2
OG0011815	0	0	0	0	1	0	1	2
OG0011816	0	0	0	0	2	0	0	2
OG0011817	0	0	0	0	1	0	1	2
OG0011818	0	0	0	0	1	0	1	2
OG0011819	0	0	0	0	2	0	0	2
OG0011820	0	0	0	0	1	0	1	2
OG0011821	0	0	0	0	2	0	0	2
OG0011822	0	0	0	0	1	0	1	2
OG0011823	0	0	0	0	2	0	0	2
OG0011824	0	0	0	0	1	1	0	2
OG0011825	0	0	0	0	1	0	1	2
OG0011826	0	0	0	0	1	0	1	2
OG0011827	0	0	0	0	1	0	1	2
OG0011828	0	0	0	0	2	0	0	2
OG0011829	0	0	0	0	1	0	1	2
OG0011830	0	0	0	0	1	0	1	2
OG0011831	0	0	0	0	1	0	1	2
OG0011832	0	0	0	0	1	0	1	2
OG0011833	0	0	0	0	1	0	1	2
OG0011834	0	0	0	0	1	0	1	2
OG0011835	0	0	0	0	1	0	1	2
OG0011836	0	0	0	0	1	0	1	2
OG0011837	0	0	0	0	1	0	1	2
OG0011838	0	0	0	0	1	0	1	2
OG0011839	0	0	0	0	1	0	1	2
OG0011840	0	0	0	0	1	0	1	2
OG0011841	0	0	0	0	1	0	1	2
OG0011842	0	0	0	0	1	0	1	2
OG0011843	0	0	0	0	1	0	1	2
OG0011844	0	0	0	0	1	0	1	2
OG0011845	0	0	0	0	1	0	1	2
OG0011846	0	0	0	0	2	0	0	2
OG0011847	0	0	0	0	1	0	1	2
OG0011848	0	0	0	0	1	0	1	2
OG0011849	0	0	0	0	1	0	1	2
OG0011850	0	0	0	0	1	0	1	2
OG0011851	0	0	0	0	1	0	1	2
OG0011852	0	0	0	0	1	0	1	2
OG0011853	0	0	0	0	1	0	1	2
OG0011854	0	0	0	0	1	0	1	2
OG0011855	0	0	0	0	1	0	1	2
OG0011856	0	0	0	0	2	0	0	2
OG0011857	0	0	0	0	2	0	0	2
OG0011858	0	0	0	0	1	0	1	2
OG0011859	0	0	0	0	1	0	1	2
OG0011860	0	0	0	0	1	0	1	2
OG0011861	0	0	0	0	1	0	1	2
OG0011862	0	0	0	0	1	0	1	2
OG0011863	0	0	0	0	1	0	1	2
OG0011864	0	0	0	0	1	0	1	2
OG0011865	0	0	0	0	1	0	1	2
OG0011866	0	0	0	0	1	0	1	2
OG0011867	0	0	0	0	1	0	1	2
OG0011868	0	0	0	0	1	0	1	2
OG0011869	0	0	0	0	1	0	1	2
OG0011870	0	0	0	0	1	0	1	2
OG0011871	0	0	0	0	1	0	1	2
OG0011872	0	0	0	0	1	0	1	2
OG0011873	0	0	0	0	1	0	1	2
OG0011874	0	0	0	0	1	0	1	2
OG0011875	0	0	0	0	1	0	1	2
OG0011876	0	0	0	0	1	0	1	2
OG0011877	0	0	0	0	1	0	1	2
OG0011878	0	0	0	0	1	0	1	2
OG0011879	0	0	0	0	2	0	0	2
OG0011880	0	0	0	0	1	0	1	2
OG0011881	0	0	0	0	1	0	1	2
OG0011882	0	0	0	0	1	0	1	2
OG0011883	0	0	0	0	1	0	1	2
OG0011884	0	0	0	0	1	0	1	2
OG0011885	0	0	0	0	1	0	1	2
OG0011886	0	0	0	0	1	0	1	2
OG0011887	0	0	0	0	1	0	1	2
OG0011888	0	0	0	0	1	0	1	2
OG0011889	0	0	0	0	2	0	0	2
OG0011890	0	0	0	0	1	0	1	2
OG0011891	0	0	0	0	1	0	1	2
OG0011892	0	0	0	0	1	0	1	2
OG0011893	0	0	0	0	1	0	1	2
OG0011894	0	0	0	0	1	0	1	2
OG0011895	0	0	0	0	1	0	1	2
OG0011896	0	0	0	0	2	0	0	2
OG0011897	0	0	0	0	1	0	1	2
OG0011898	0	0	0	0	1	0	1	2
OG0011899	0	0	0	0	1	0	1	2
OG0011900	0	0	0	0	2	0	0	2
OG0011901	0	0	0	0	2	0	0	2
OG0011902	0	0	0	0	1	0	1	2
OG0011903	0	0	0	0	1	0	1	2
OG0011904	0	0	0	0	1	0	1	2
OG0011905	0	0	0	0	1	0	1	2
OG0011906	0	0	0	0	1	0	1	2
OG0011907	0	0	0	0	1	0	1	2
OG0011908	0	0	0	0	1	0	1	2
OG0011909	0	0	0	0	2	0	0	2
OG0011910	0	0	0	0	2	0	0	2
OG0011911	0	0	0	0	1	0	1	2
OG0011912	0	0	0	0	1	0	1	2
OG0011913	0	0	0	0	1	0	1	2
OG0011914	0	0	0	0	1	0	1	2
OG0011915	0	0	0	0	1	0	1	2
OG0011916	0	0	0	0	1	0	1	2
OG0011917	0	0	0	0	1	0	1	2
OG0011918	0	0	0	0	2	0	0	2
OG0011919	0	0	0	0	1	0	1	2
OG0011920	0	0	0	0	1	0	1	2
OG0011921	0	0	0	0	1	0	1	2
OG0011922	0	0	0	0	2	0	0	2
OG0011923	0	0	0	0	1	0	1	2
OG0011924	0	0	0	0	1	0	1	2
OG0011925	0	0	0	0	1	0	1	2
OG0011926	0	0	0	0	1	0	1	2
OG0011927	0	0	0	0	2	0	0	2
OG0011928	0	0	0	0	1	0	1	2
OG0011929	0	0	0	0	1	0	1	2
OG0011930	0	0	0	0	1	0	1	2
OG0011931	0	0	0	0	1	0	1	2
OG0011932	0	0	0	0	1	0	1	2
OG0011933	0	0	0	0	1	0	1	2
OG0011934	0	0	0	0	1	0	1	2
OG0011935	0	0	0	0	1	0	1	2
OG0011936	0	0	0	0	1	0	1	2
OG0011937	0	0	0	0	1	0	1	2
OG0011938	0	0	0	0	1	0	1	2
OG0011939	0	0	0	0	1	0	1	2
OG0011940	0	0	0	0	1	0	1	2
OG0011941	0	0	0	0	1	0	1	2
OG0011942	0	0	0	0	1	0	1	2
OG0011943	0	0	0	0	2	0	0	2
OG0011944	0	0	0	0	1	0	1	2
OG0011945	0	0	0	0	1	0	1	2
OG0011946	0	0	0	0	1	0	1	2
OG0011947	0	0	0	0	1	0	1	2
OG0011948	0	0	0	0	1	0	1	2
OG0011949	0	0	0	0	2	0	0	2
OG0011950	0	0	0	0	2	0	0	2
OG0011951	0	0	0	0	2	0	0	2
OG0011952	0	0	0	0	1	0	1	2
OG0011953	0	0	0	0	2	0	0	2
OG0011954	0	0	0	0	1	0	1	2
OG0011955	0	0	0	0	1	0	1	2
OG0011956	0	0	0	0	1	0	1	2
OG0011957	0	0	0	0	2	0	0	2
OG0011958	0	0	0	0	1	0	1	2
OG0011959	0	0	0	0	2	0	0	2
OG0011960	0	0	0	0	1	0	1	2
OG0011961	0	0	0	0	2	0	0	2
OG0011962	0	0	0	0	1	0	1	2
OG0011963	0	0	0	0	1	0	1	2
OG0011964	0	0	0	0	2	0	0	2
OG0011965	0	0	0	0	1	1	0	2
OG0011966	0	0	0	0	1	0	1	2
OG0011967	0	0	0	0	2	0	0	2
OG0011968	0	0	0	0	1	0	1	2
OG0011969	0	0	0	0	1	0	1	2
OG0011970	0	0	0	0	1	0	1	2
OG0011971	0	0	0	0	1	0	1	2
OG0011972	0	0	0	0	1	0	1	2
OG0011973	0	0	0	0	2	0	0	2
OG0011974	0	0	0	0	2	0	0	2
OG0011975	0	0	0	0	2	0	0	2
OG0011976	0	0	0	0	2	0	0	2
OG0011977	0	0	0	0	2	0	0	2
OG0011978	0	0	0	0	1	0	1	2
OG0011979	0	0	0	0	1	0	1	2
OG0011980	0	0	0	0	1	0	1	2
OG0011981	0	0	0	0	1	0	1	2
OG0011982	0	0	0	0	1	0	1	2
OG0011983	0	0	0	0	1	0	1	2
OG0011984	0	0	0	0	2	0	0	2
OG0011985	0	0	0	0	2	0	0	2
OG0011986	0	0	0	0	1	0	1	2
OG0011987	0	0	0	0	1	0	1	2
OG0011988	0	0	0	0	1	0	1	2
OG0011989	0	0	0	0	1	0	1	2
OG0011990	0	0	0	0	1	0	1	2
OG0011991	0	0	0	0	1	0	1	2
OG0011992	0	0	0	0	1	0	1	2
OG0011993	0	0	0	0	1	0	1	2
OG0011994	0	0	0	0	1	0	1	2
OG0011995	0	0	0	0	1	0	1	2
OG0011996	0	0	0	0	1	0	1	2
OG0011997	0	0	0	0	1	0	1	2
OG0011998	0	0	0	0	1	0	1	2
OG0011999	0	0	0	0	1	0	1	2
OG0012000	0	0	0	0	2	0	0	2
OG0012001	0	0	0	0	1	0	1	2
OG0012002	0	0	0	0	1	0	1	2
OG0012003	0	0	0	0	2	0	0	2
OG0012004	0	0	0	0	1	0	1	2
OG0012005	0	0	0	0	2	0	0	2
OG0012006	0	0	0	0	1	0	1	2
OG0012007	0	0	0	0	2	0	0	2
OG0012008	0	0	0	0	1	0	1	2
OG0012009	0	0	0	0	1	0	1	2
OG0012010	0	0	0	0	1	0	1	2
OG0012011	0	0	0	0	1	0	1	2
OG0012012	0	0	0	0	1	0	1	2
OG0012013	0	0	0	0	1	0	1	2
OG0012014	0	0	0	0	2	0	0	2
OG0012015	0	0	0	0	1	0	1	2
OG0012016	0	0	0	0	1	0	1	2
OG0012017	0	0	0	0	1	0	1	2
OG0012018	0	0	0	0	2	0	0	2
OG0012019	0	0	0	0	1	0	1	2
OG0012020	0	0	0	0	1	0	1	2
OG0012021	0	0	0	0	1	0	1	2
OG0012022	0	0	0	0	1	0	1	2
OG0012023	0	0	0	0	1	0	1	2
OG0012024	0	0	0	0	1	0	1	2
OG0012025	0	0	0	0	2	0	0	2
OG0012026	0	0	0	0	2	0	0	2
OG0012027	0	0	0	0	1	0	1	2
OG0012028	0	0	0	0	1	0	1	2
OG0012029	0	0	0	0	1	0	1	2
OG0012030	0	0	0	0	1	0	1	2
OG0012031	0	0	0	0	1	0	1	2
OG0012032	0	0	0	0	1	0	1	2
OG0012033	0	0	0	0	1	0	1	2
OG0012034	0	0	0	0	2	0	0	2
OG0012035	0	0	0	0	1	0	1	2
OG0012036	0	0	0	0	1	0	1	2
OG0012037	0	0	0	0	1	0	1	2
OG0012038	0	0	0	0	1	0	1	2
OG0012039	0	0	0	0	1	0	1	2
OG0012040	0	0	0	0	1	0	1	2
OG0012041	0	0	0	0	1	0	1	2
OG0012042	0	0	0	0	1	0	1	2
OG0012043	0	0	0	0	1	0	1	2
OG0012044	0	0	0	0	1	0	1	2
OG0012045	0	0	0	0	1	0	1	2
OG0012046	0	0	0	0	1	0	1	2
OG0012047	0	0	0	0	1	0	1	2
OG0012048	0	0	0	0	1	0	1	2
OG0012049	0	0	0	0	1	0	1	2
OG0012050	0	0	0	0	1	0	1	2
OG0012051	0	0	0	0	1	0	1	2
OG0012052	0	0	0	0	1	0	1	2
OG0012053	0	0	0	0	1	0	1	2
OG0012054	0	0	0	0	1	0	1	2
OG0012055	0	0	0	0	1	0	1	2
OG0012056	0	0	0	0	1	0	1	2
OG0012057	0	0	0	0	1	0	1	2
OG0012058	0	0	0	0	2	0	0	2
OG0012059	0	0	0	0	1	0	1	2
OG0012060	0	0	0	0	1	0	1	2
OG0012061	0	0	0	0	1	0	1	2
OG0012062	0	0	0	0	1	0	1	2
OG0012063	0	0	0	0	1	0	1	2
OG0012064	0	0	0	0	1	0	1	2
OG0012065	0	0	0	0	1	0	1	2
OG0012066	0	0	0	0	2	0	0	2
OG0012067	0	0	0	0	1	0	1	2
OG0012068	0	0	0	0	1	0	1	2
OG0012069	0	0	0	0	1	0	1	2
OG0012070	0	0	0	0	1	0	1	2
OG0012071	0	0	0	0	1	0	1	2
OG0012072	0	0	0	0	1	0	1	2
OG0012073	0	0	0	0	1	0	1	2
OG0012074	0	0	0	0	1	0	1	2
OG0012075	0	0	0	0	2	0	0	2
OG0012076	0	0	0	0	1	0	1	2
OG0012077	0	0	0	0	1	0	1	2
OG0012078	0	0	0	0	1	0	1	2
OG0012079	0	0	0	0	1	0	1	2
OG0012080	0	0	0	0	1	0	1	2
OG0012081	0	0	0	0	1	0	1	2
OG0012082	0	0	0	0	1	0	1	2
OG0012083	0	0	0	0	1	0	1	2
OG0012084	0	0	0	0	2	0	0	2
OG0012085	0	0	0	0	1	0	1	2
OG0012086	0	0	0	0	1	0	1	2
OG0012087	0	0	0	0	1	0	1	2
OG0012088	0	0	0	0	1	0	1	2
OG0012089	0	0	0	0	1	0	1	2
OG0012090	0	0	0	0	1	0	1	2
OG0012091	0	0	0	0	1	0	1	2
OG0012092	0	0	0	0	1	0	1	2
OG0012093	0	0	0	0	1	0	1	2
OG0012094	0	0	0	0	1	0	1	2
OG0012095	0	0	0	0	1	0	1	2
OG0012096	0	0	0	0	1	0	1	2
OG0012097	0	0	0	0	1	0	1	2
OG0012098	0	0	0	0	1	0	1	2
OG0012099	0	0	0	0	1	0	1	2
OG0012100	0	0	0	0	1	0	1	2
OG0012101	0	0	0	0	2	0	0	2
OG0012102	0	0	0	0	1	0	1	2
OG0012103	0	0	0	0	1	0	1	2
OG0012104	0	0	0	0	1	0	1	2
OG0012105	0	0	0	0	1	0	1	2
OG0012106	0	0	0	0	1	1	0	2
OG0012107	0	0	0	0	1	0	1	2
OG0012108	0	0	0	0	1	0	1	2
OG0012109	0	0	0	0	1	0	1	2
OG0012110	0	0	0	0	1	1	0	2
OG0012111	0	0	0	0	1	0	1	2
OG0012112	0	0	0	0	1	0	1	2
OG0012113	0	0	0	0	1	0	1	2
OG0012114	0	0	0	0	1	0	1	2
OG0012115	0	0	0	0	1	0	1	2
OG0012116	0	0	0	0	1	0	1	2
OG0012117	0	0	0	0	1	0	1	2
OG0012118	0	0	0	0	1	0	1	2
OG0012119	0	0	0	0	1	0	1	2
OG0012120	0	0	0	0	1	0	1	2
OG0012121	0	0	0	0	2	0	0	2
OG0012122	0	0	0	0	1	0	1	2
OG0012123	0	0	0	0	1	0	1	2
OG0012124	0	0	0	0	1	0	1	2
OG0012125	0	0	0	0	2	0	0	2
OG0012126	0	0	0	0	2	0	0	2
OG0012127	0	0	0	0	1	0	1	2
OG0012128	0	0	0	0	2	0	0	2
OG0012129	0	0	0	0	1	0	1	2
OG0012130	0	0	0	0	1	0	1	2
OG0012131	0	0	0	0	1	0	1	2
OG0012132	0	0	0	0	1	0	1	2
OG0012133	0	0	0	0	2	0	0	2
OG0012134	0	0	0	0	1	0	1	2
OG0012135	0	0	0	0	1	0	1	2
OG0012136	0	0	0	0	1	0	1	2
OG0012137	0	0	0	0	1	0	1	2
OG0012138	0	0	0	0	1	0	1	2
OG0012139	0	0	0	0	1	0	1	2
OG0012140	0	0	0	0	1	1	0	2
OG0012141	0	0	0	0	1	0	1	2
OG0012142	0	0	0	0	1	0	1	2
OG0012143	0	0	0	0	1	0	1	2
OG0012144	0	0	0	0	1	0	1	2
OG0012145	0	0	0	0	1	0	1	2
OG0012146	0	0	0	0	1	0	1	2
OG0012147	0	0	0	0	1	0	1	2
OG0012148	0	0	0	0	1	0	1	2
OG0012149	0	0	0	0	1	0	1	2
OG0012150	0	0	0	0	2	0	0	2
OG0012151	0	0	0	0	1	0	1	2
OG0012152	0	0	0	0	1	0	1	2
OG0012153	0	0	0	0	1	0	1	2
OG0012154	0	0	0	0	1	0	1	2
OG0012155	0	0	0	0	1	0	1	2
OG0012156	0	0	0	0	1	0	1	2
OG0012157	0	0	0	0	1	0	1	2
OG0012158	0	0	0	0	1	0	1	2
OG0012159	0	0	0	0	1	0	1	2
OG0012160	0	0	0	0	1	0	1	2
OG0012161	0	0	0	0	1	0	1	2
OG0012162	0	0	0	0	1	0	1	2
OG0012163	0	0	0	0	1	0	1	2
OG0012164	0	0	0	0	1	0	1	2
OG0012165	0	0	0	0	1	0	1	2
OG0012166	0	0	0	0	1	0	1	2
OG0012167	0	0	0	0	1	0	1	2
OG0012168	0	0	0	0	1	0	1	2
OG0012169	0	0	0	0	1	0	1	2
OG0012170	0	0	0	0	1	0	1	2
OG0012171	0	0	0	0	1	0	1	2
OG0012172	0	0	0	0	1	0	1	2
OG0012173	0	0	0	0	1	0	1	2
OG0012174	0	0	0	0	1	0	1	2
OG0012175	0	0	0	0	1	0	1	2
OG0012176	0	0	0	0	1	0	1	2
OG0012177	0	0	0	0	1	0	1	2
OG0012178	0	0	0	0	1	0	1	2
OG0012179	0	0	0	0	1	0	1	2
OG0012180	0	0	0	0	2	0	0	2
OG0012181	0	0	0	0	1	0	1	2
OG0012182	0	0	0	0	1	0	1	2
OG0012183	0	0	0	0	1	0	1	2
OG0012184	0	0	0	0	1	0	1	2
OG0012185	0	0	0	0	1	0	1	2
OG0012186	0	0	0	0	1	0	1	2
OG0012187	0	0	0	0	1	0	1	2
OG0012188	0	0	0	0	1	0	1	2
OG0012189	0	0	0	0	1	0	1	2
OG0012190	0	0	0	0	1	0	1	2
OG0012191	0	0	0	0	1	0	1	2
OG0012192	0	0	0	0	1	0	1	2
OG0012193	0	0	0	0	2	0	0	2
OG0012194	0	0	0	0	1	0	1	2
OG0012195	0	0	0	0	1	0	1	2
OG0012196	0	0	0	0	2	0	0	2
OG0012197	0	0	0	0	1	0	1	2
OG0012198	0	0	0	0	2	0	0	2
OG0012199	0	0	0	0	1	0	1	2
OG0012200	0	0	0	0	1	0	1	2
OG0012201	0	0	0	0	1	0	1	2
OG0012202	0	0	0	0	2	0	0	2
OG0012203	0	0	0	0	1	0	1	2
OG0012204	0	0	0	0	1	0	1	2
OG0012205	0	0	0	0	1	0	1	2
OG0012206	0	0	0	0	1	0	1	2
OG0012207	0	0	0	0	1	0	1	2
OG0012208	0	0	0	0	1	0	1	2
OG0012209	0	0	0	0	1	0	1	2
OG0012210	0	0	0	0	1	0	1	2
OG0012211	0	0	0	0	1	0	1	2
OG0012212	0	0	0	0	1	1	0	2
OG0012213	0	0	0	0	1	0	1	2
OG0012214	0	0	0	0	1	0	1	2
OG0012215	0	0	0	0	1	0	1	2
OG0012216	0	0	0	0	1	0	1	2
OG0012217	0	0	0	0	1	0	1	2
OG0012218	0	0	0	0	2	0	0	2
OG0012219	0	0	0	0	1	0	1	2
OG0012220	0	0	0	0	1	0	1	2
OG0012221	0	0	0	0	1	0	1	2
OG0012222	0	0	0	0	1	0	1	2
OG0012223	0	0	0	0	1	0	1	2
OG0012224	0	0	0	0	1	0	1	2
OG0012225	0	0	0	0	1	0	1	2
OG0012226	0	0	0	0	1	0	1	2
OG0012227	0	0	0	0	1	0	1	2
OG0012228	0	0	0	0	1	0	1	2
OG0012229	0	0	0	0	1	0	1	2
OG0012230	0	0	0	0	1	0	1	2
OG0012231	0	0	0	0	1	0	1	2
OG0012232	0	0	0	0	2	0	0	2
OG0012233	0	0	0	0	1	0	1	2
OG0012234	0	0	0	0	1	0	1	2
OG0012235	0	0	0	0	1	0	1	2
OG0012236	0	0	0	0	1	0	1	2
OG0012237	0	0	0	0	1	0	1	2
OG0012238	0	0	0	0	1	0	1	2
OG0012239	0	0	0	0	1	0	1	2
OG0012240	0	0	0	0	1	0	1	2
OG0012241	0	0	0	0	1	0	1	2
OG0012242	0	0	0	0	1	0	1	2
OG0012243	0	0	0	0	1	0	1	2
OG0012244	0	0	0	0	1	0	1	2
OG0012245	0	0	0	0	1	0	1	2
OG0012246	0	0	0	0	1	0	1	2
OG0012247	0	0	0	0	1	0	1	2
OG0012248	0	0	0	0	1	0	1	2
OG0012249	0	0	0	0	1	0	1	2
OG0012250	0	0	0	0	1	0	1	2
OG0012251	0	0	0	0	1	0	1	2
OG0012252	0	0	0	0	1	0	1	2
OG0012253	0	0	0	0	1	0	1	2
OG0012254	0	0	0	0	1	0	1	2
OG0012255	0	0	0	0	1	0	1	2
OG0012256	0	0	0	0	1	0	1	2
OG0012257	0	0	0	0	1	0	1	2
OG0012258	0	0	0	0	1	0	1	2
OG0012259	0	0	0	0	1	0	1	2
OG0012260	0	0	0	0	1	0	1	2
OG0012261	0	0	0	0	1	0	1	2
OG0012262	0	0	0	0	1	0	1	2
OG0012263	0	0	0	0	1	0	1	2
OG0012264	0	0	0	0	1	0	1	2
OG0012265	0	0	0	0	1	0	1	2
OG0012266	0	0	0	0	1	0	1	2
OG0012267	0	0	0	0	1	0	1	2
OG0012268	0	0	0	0	1	0	1	2
OG0012269	0	0	0	0	1	0	1	2
OG0012270	0	0	0	0	1	0	1	2
OG0012271	0	0	0	0	1	0	1	2
OG0012272	0	0	0	0	1	0	1	2
OG0012273	0	0	0	0	1	0	1	2
OG0012274	0	0	0	0	1	0	1	2
OG0012275	0	0	0	0	1	0	1	2
OG0012276	0	0	0	0	1	0	1	2
OG0012277	0	0	0	0	1	0	1	2
OG0012278	0	0	0	0	1	0	1	2
OG0012279	0	0	0	0	1	0	1	2
OG0012280	0	0	0	0	1	0	1	2
OG0012281	0	0	0	0	1	0	1	2
OG0012282	0	0	0	0	2	0	0	2
OG0012283	0	0	0	0	1	0	1	2
OG0012284	0	0	0	0	1	0	1	2
OG0012285	0	0	0	0	1	0	1	2
OG0012286	0	0	0	0	1	0	1	2
OG0012287	0	0	0	0	1	0	1	2
OG0012288	0	0	0	0	1	0	1	2
OG0012289	0	0	0	0	1	0	1	2
OG0012290	0	0	0	0	1	0	1	2
OG0012291	0	0	0	0	1	0	1	2
OG0012292	0	0	0	0	1	0	1	2
OG0012293	0	0	0	0	1	0	1	2
OG0012294	0	0	0	0	2	0	0	2
OG0012295	0	0	0	0	1	0	1	2
OG0012296	0	0	0	0	1	0	1	2
OG0012297	0	0	0	0	1	0	1	2
OG0012298	0	0	0	0	1	0	1	2
OG0012299	0	0	0	0	1	0	1	2
OG0012300	0	0	0	0	1	0	1	2
OG0012301	0	0	0	0	1	0	1	2
OG0012302	0	0	0	0	1	0	1	2
OG0012303	0	0	0	0	1	0	1	2
OG0012304	0	0	0	0	1	0	1	2
OG0012305	0	0	0	0	1	0	1	2
OG0012306	0	0	0	0	1	0	1	2
OG0012307	0	0	0	0	1	0	1	2
OG0012308	0	0	0	0	1	0	1	2
OG0012309	0	0	0	0	1	0	1	2
OG0012310	0	0	0	0	1	0	1	2
OG0012311	0	0	0	0	1	0	1	2
OG0012312	0	0	0	0	1	0	1	2
OG0012313	0	0	0	0	1	0	1	2
OG0012314	0	0	0	0	1	0	1	2
OG0012315	0	0	0	0	1	0	1	2
OG0012316	0	0	0	0	1	0	1	2
OG0012317	0	0	0	0	1	0	1	2
OG0012318	0	0	0	0	1	0	1	2
OG0012319	0	0	0	0	1	0	1	2
OG0012320	0	0	0	0	1	0	1	2
OG0012321	0	0	0	0	1	0	1	2
OG0012322	0	0	0	0	2	0	0	2
OG0012323	0	0	0	0	1	0	1	2
OG0012324	0	0	0	0	1	0	1	2
OG0012325	0	0	0	0	1	0	1	2
OG0012326	0	0	0	0	1	0	1	2
OG0012327	0	0	0	0	1	0	1	2
OG0012328	0	0	0	0	1	0	1	2
OG0012329	0	0	0	0	1	0	1	2
OG0012330	0	0	0	0	1	0	1	2
OG0012331	0	0	0	0	1	0	1	2
OG0012332	0	0	0	0	1	0	1	2
OG0012333	0	0	0	0	1	0	1	2
OG0012334	0	0	0	0	1	0	1	2
OG0012335	0	0	0	0	1	0	1	2
OG0012336	0	0	0	0	1	0	1	2
OG0012337	0	0	0	0	1	0	1	2
OG0012338	0	0	0	0	1	0	1	2
OG0012339	0	0	0	0	1	0	1	2
OG0012340	0	0	0	0	1	0	1	2
OG0012341	0	0	0	0	1	0	1	2
OG0012342	0	0	0	0	1	0	1	2
OG0012343	0	0	0	0	1	0	1	2
OG0012344	0	0	0	0	1	0	1	2
OG0012345	0	0	0	0	1	0	1	2
OG0012346	0	0	0	0	1	0	1	2
OG0012347	0	0	0	0	1	0	1	2
OG0012348	0	0	0	0	1	0	1	2
OG0012349	0	0	0	0	1	0	1	2
OG0012350	0	0	0	0	1	0	1	2
OG0012351	0	0	0	0	1	0	1	2
OG0012352	0	0	0	0	1	0	1	2
OG0012353	0	0	0	0	2	0	0	2
OG0012354	0	0	0	0	1	0	1	2
OG0012355	0	0	0	0	1	0	1	2
OG0012356	0	0	0	0	1	0	1	2
OG0012357	0	0	0	0	1	0	1	2
OG0012358	0	0	0	0	1	0	1	2
OG0012359	0	0	0	0	1	0	1	2
OG0012360	0	0	0	0	1	0	1	2
OG0012361	0	0	0	0	1	1	0	2
OG0012362	0	0	0	0	1	0	1	2
OG0012363	0	0	0	0	1	0	1	2
OG0012364	0	0	0	0	1	0	1	2
OG0012365	0	0	0	0	1	0	1	2
OG0012366	0	0	0	0	2	0	0	2
OG0012367	0	0	0	0	1	0	1	2
OG0012368	0	0	0	0	1	0	1	2
OG0012369	0	0	0	0	1	0	1	2
OG0012370	0	0	0	0	1	0	1	2
OG0012371	0	0	0	0	1	0	1	2
OG0012372	0	0	0	0	1	0	1	2
OG0012373	0	0	0	0	1	0	1	2
OG0012374	0	0	0	0	1	0	1	2
OG0012375	0	0	0	0	1	0	1	2
OG0012376	0	0	0	0	1	0	1	2
OG0012377	0	0	0	0	1	0	1	2
OG0012378	0	0	0	0	1	0	1	2
OG0012379	0	0	0	0	1	0	1	2
OG0012380	0	0	0	0	1	0	1	2
OG0012381	0	0	0	0	1	0	1	2
OG0012382	0	0	0	0	1	0	1	2
OG0012383	0	0	0	0	1	0	1	2
OG0012384	0	0	0	0	1	0	1	2
OG0012385	0	0	0	0	1	0	1	2
OG0012386	0	0	0	0	1	0	1	2
OG0012387	0	0	0	0	1	0	1	2
OG0012388	0	0	0	0	1	0	1	2
OG0012389	0	0	0	0	1	0	1	2
OG0012390	0	0	0	0	1	0	1	2
OG0012391	0	0	0	0	1	0	1	2
OG0012392	0	0	0	0	1	0	1	2
OG0012393	0	0	0	0	1	0	1	2
OG0012394	0	0	0	0	1	0	1	2
OG0012395	0	0	0	0	1	0	1	2
OG0012396	0	0	0	0	1	0	1	2
OG0012397	0	0	0	0	1	0	1	2
OG0012398	0	0	0	0	1	0	1	2
OG0012399	0	0	0	0	1	0	1	2
OG0012400	0	0	0	0	1	0	1	2
OG0012401	0	0	0	0	1	0	1	2
OG0012402	0	0	0	0	1	0	1	2
OG0012403	0	0	0	0	1	0	1	2
OG0012404	0	0	0	0	1	0	1	2
OG0012405	0	0	0	0	1	0	1	2
OG0012406	0	0	0	0	1	0	1	2
OG0012407	0	0	0	0	1	0	1	2
OG0012408	0	0	0	0	1	0	1	2
OG0012409	0	0	0	0	1	0	1	2
OG0012410	0	0	0	0	1	0	1	2
OG0012411	0	0	0	0	1	0	1	2
OG0012412	0	0	0	0	1	0	1	2
OG0012413	0	0	0	0	1	0	1	2
OG0012414	0	0	0	0	1	0	1	2
OG0012415	0	0	0	0	1	0	1	2
OG0012416	0	0	0	0	1	0	1	2
OG0012417	0	0	0	0	1	0	1	2
OG0012418	0	0	0	0	1	0	1	2
OG0012419	0	0	0	0	1	0	1	2
OG0012420	0	0	0	0	1	0	1	2
OG0012421	0	0	0	0	1	0	1	2
OG0012422	0	0	0	0	1	0	1	2
OG0012423	0	0	0	0	1	0	1	2
OG0012424	0	0	0	0	1	0	1	2
OG0012425	0	0	0	0	1	0	1	2
OG0012426	0	0	0	0	1	0	1	2
OG0012427	0	0	0	0	1	0	1	2
OG0012428	0	0	0	0	2	0	0	2
OG0012429	0	0	0	0	1	0	1	2
OG0012430	0	0	0	0	1	0	1	2
OG0012431	0	0	0	0	1	0	1	2
OG0012432	0	0	0	0	1	0	1	2
OG0012433	0	0	0	0	1	0	1	2
OG0012434	0	0	0	0	1	0	1	2
OG0012435	0	0	0	0	1	0	1	2
OG0012436	0	0	0	0	1	0	1	2
OG0012437	0	0	0	0	1	0	1	2
OG0012438	0	0	0	0	1	0	1	2
OG0012439	0	0	0	0	1	0	1	2
OG0012440	0	0	0	0	1	0	1	2
OG0012441	0	0	0	0	1	0	1	2
OG0012442	0	0	0	0	1	0	1	2
OG0012443	0	0	0	0	1	0	1	2
OG0012444	0	0	0	0	1	0	1	2
OG0012445	0	0	0	0	1	0	1	2
OG0012446	0	0	0	0	1	0	1	2
OG0012447	0	0	0	0	2	0	0	2
OG0012448	0	0	0	0	1	0	1	2
OG0012449	0	0	0	0	1	0	1	2
OG0012450	0	0	0	0	1	0	1	2
OG0012451	0	0	0	0	1	0	1	2
OG0012452	0	0	0	0	1	0	1	2
OG0012453	0	0	0	0	1	0	1	2
OG0012454	0	0	0	0	1	0	1	2
OG0012455	0	0	0	0	1	0	1	2
OG0012456	0	0	0	0	1	0	1	2
OG0012457	0	0	0	0	1	0	1	2
OG0012458	0	0	0	0	1	0	1	2
OG0012459	0	0	0	0	1	0	1	2
OG0012460	0	0	0	0	1	0	1	2
OG0012461	0	0	0	0	1	0	1	2
OG0012462	0	0	0	0	1	0	1	2
OG0012463	0	0	0	0	1	0	1	2
OG0012464	0	0	0	0	1	0	1	2
OG0012465	0	0	0	0	1	0	1	2
OG0012466	0	0	0	0	1	0	1	2
OG0012467	0	0	0	0	1	0	1	2
OG0012468	0	0	0	0	1	0	1	2
OG0012469	0	0	0	0	1	0	1	2
OG0012470	0	0	0	0	1	0	1	2
OG0012471	0	0	0	0	1	0	1	2
OG0012472	0	0	0	0	1	0	1	2
OG0012473	0	0	0	0	1	0	1	2
OG0012474	0	0	0	0	2	0	0	2
OG0012475	0	0	0	0	1	0	1	2
OG0012476	0	0	0	0	1	0	1	2
OG0012477	0	0	0	0	1	0	1	2
OG0012478	0	0	0	0	1	0	1	2
OG0012479	0	0	0	0	1	0	1	2
OG0012480	0	0	0	0	1	0	1	2
OG0012481	0	0	0	0	1	0	1	2
OG0012482	0	0	0	0	1	0	1	2
OG0012483	0	0	0	0	1	0	1	2
OG0012484	0	0	0	0	1	0	1	2
OG0012485	0	0	0	0	1	0	1	2
OG0012486	0	0	0	0	1	0	1	2
OG0012487	0	0	0	0	1	0	1	2
OG0012488	0	0	0	0	2	0	0	2
OG0012489	0	0	0	0	1	0	1	2
OG0012490	0	0	0	0	1	0	1	2
OG0012491	0	0	0	0	1	0	1	2
OG0012492	0	0	0	0	1	0	1	2
OG0012493	0	0	0	0	1	0	1	2
OG0012494	0	0	0	0	1	0	1	2
OG0012495	0	0	0	0	1	0	1	2
OG0012496	0	0	0	0	1	0	1	2
OG0012497	0	0	0	0	1	0	1	2
OG0012498	0	0	0	0	1	0	1	2
OG0012499	0	0	0	0	1	0	1	2
OG0012500	0	0	0	0	1	0	1	2
OG0012501	0	0	0	0	1	0	1	2
OG0012502	0	0	0	0	1	0	1	2
OG0012503	0	0	0	0	1	0	1	2
OG0012504	0	0	0	0	1	0	1	2
OG0012505	0	0	0	0	1	0	1	2
OG0012506	0	0	0	0	1	0	1	2
OG0012507	0	0	0	0	1	0	1	2
OG0012508	0	0	0	0	1	0	1	2
OG0012509	0	0	0	0	1	0	1	2
OG0012510	0	0	0	0	1	0	1	2
OG0012511	0	0	0	0	1	0	1	2
OG0012512	0	0	0	0	1	0	1	2
OG0012513	0	0	0	0	1	0	1	2
OG0012514	0	0	0	0	1	0	1	2
OG0012515	0	0	0	0	1	0	1	2
OG0012516	0	0	0	0	1	0	1	2
OG0012517	0	0	0	0	1	0	1	2
OG0012518	0	0	0	0	1	0	1	2
OG0012519	0	0	0	0	1	0	1	2
OG0012520	0	0	0	0	1	0	1	2
OG0012521	0	0	0	0	1	0	1	2
OG0012522	0	0	0	0	1	0	1	2
OG0012523	0	0	0	0	1	0	1	2
OG0012524	0	0	0	0	1	0	1	2
OG0012525	0	0	0	0	1	0	1	2
OG0012526	0	0	0	0	1	0	1	2
OG0012527	0	0	0	0	1	0	1	2
OG0012528	0	0	0	0	1	0	1	2
OG0012529	0	0	0	0	1	0	1	2
OG0012530	0	0	0	0	1	0	1	2
OG0012531	0	0	0	0	1	0	1	2
OG0012532	0	0	0	0	1	0	1	2
OG0012533	0	0	0	0	1	0	1	2
OG0012534	0	0	0	0	1	0	1	2
OG0012535	0	0	0	0	1	0	1	2
OG0012536	0	0	0	0	1	0	1	2
OG0012537	0	0	0	0	1	0	1	2
OG0012538	0	0	0	0	1	0	1	2
OG0012539	0	0	0	0	1	0	1	2
OG0012540	0	0	0	0	1	0	1	2
OG0012541	0	0	0	0	1	0	1	2
OG0012542	0	0	0	0	1	0	1	2
OG0012543	0	0	0	0	1	0	1	2
OG0012544	0	0	0	0	1	0	1	2
OG0012545	0	0	0	0	1	0	1	2
OG0012546	0	0	0	0	1	0	1	2
OG0012547	0	0	0	0	1	0	1	2
OG0012548	0	0	0	0	1	0	1	2
OG0012549	0	0	0	0	1	0	1	2
OG0012550	0	0	0	0	1	0	1	2
OG0012551	0	0	0	0	1	0	1	2
OG0012552	0	0	0	0	1	0	1	2
OG0012553	0	0	0	0	1	0	1	2
OG0012554	0	0	0	0	1	0	1	2
OG0012555	0	0	0	0	1	0	1	2
OG0012556	0	0	0	0	1	0	1	2
OG0012557	0	0	0	0	1	0	1	2
OG0012558	0	0	0	0	1	0	1	2
OG0012559	0	0	0	0	1	0	1	2
OG0012560	0	0	0	0	1	0	1	2
OG0012561	0	0	0	0	1	0	1	2
OG0012562	0	0	0	0	1	0	1	2
OG0012563	0	0	0	0	1	0	1	2
OG0012564	0	0	0	0	1	0	1	2
OG0012565	0	0	0	0	1	0	1	2
OG0012566	0	0	0	0	1	0	1	2
OG0012567	0	0	0	0	1	0	1	2
OG0012568	0	0	0	0	1	0	1	2
OG0012569	0	0	0	0	2	0	0	2
OG0012570	0	0	0	0	1	0	1	2
OG0012571	0	0	0	0	1	0	1	2
OG0012572	0	0	0	0	2	0	0	2
OG0012573	0	0	0	0	2	0	0	2
OG0012574	0	0	0	0	1	0	1	2
OG0012575	0	0	0	0	1	0	1	2
OG0012576	0	0	0	0	2	0	0	2
OG0012577	0	0	0	0	1	0	1	2
OG0012578	0	0	0	0	1	0	1	2
OG0012579	0	0	0	0	1	0	1	2
OG0012580	0	0	0	0	2	0	0	2
OG0012581	0	0	0	0	1	0	1	2
OG0012582	0	0	0	0	1	0	1	2
OG0012583	0	0	0	0	1	0	1	2
OG0012584	0	0	0	0	1	0	1	2
OG0012585	0	0	0	0	1	0	1	2
OG0012586	0	0	0	0	1	0	1	2
OG0012587	0	0	0	0	1	0	1	2
OG0012588	0	0	0	0	1	0	1	2
OG0012589	0	0	0	0	1	0	1	2
OG0012590	0	0	0	0	1	0	1	2
OG0012591	0	0	0	0	1	0	1	2
OG0012592	0	0	0	0	1	0	1	2
OG0012593	0	0	0	0	1	0	1	2
OG0012594	0	0	0	0	1	0	1	2
OG0012595	0	0	0	0	1	0	1	2
OG0012596	0	0	0	0	1	0	1	2
OG0012597	0	0	0	0	1	0	1	2
OG0012598	0	0	0	0	1	0	1	2
OG0012599	0	0	0	0	1	0	1	2
OG0012600	0	0	0	0	1	0	1	2
OG0012601	0	0	0	0	1	0	1	2
OG0012602	0	0	0	0	1	0	1	2
OG0012603	0	0	0	0	1	0	1	2
OG0012604	0	0	0	0	1	0	1	2
OG0012605	0	0	0	0	1	0	1	2
OG0012606	0	0	0	0	1	0	1	2
OG0012607	0	0	0	0	1	0	1	2
OG0012608	0	0	0	0	1	0	1	2
OG0012609	0	0	0	0	1	0	1	2
OG0012610	0	0	0	0	1	0	1	2
OG0012611	0	0	0	0	1	0	1	2
OG0012612	0	0	0	0	1	0	1	2
OG0012613	0	0	0	0	1	0	1	2
OG0012614	0	0	0	0	1	0	1	2
OG0012615	0	0	0	0	1	0	1	2
OG0012616	0	0	0	0	1	0	1	2
OG0012617	0	0	0	0	1	0	1	2
OG0012618	0	0	0	0	1	0	1	2
OG0012619	0	0	0	0	1	0	1	2
OG0012620	0	0	0	0	1	0	1	2
OG0012621	0	0	0	0	1	0	1	2
OG0012622	0	0	0	0	1	0	1	2
OG0012623	0	0	0	0	1	0	1	2
OG0012624	0	0	0	0	1	0	1	2
OG0012625	0	0	0	0	1	0	1	2
OG0012626	0	0	0	0	1	0	1	2
OG0012627	0	0	0	0	1	0	1	2
OG0012628	0	0	0	0	1	0	1	2
OG0012629	0	0	0	0	1	0	1	2
OG0012630	0	0	0	0	1	0	1	2
OG0012631	0	0	0	0	1	0	1	2
OG0012632	0	0	0	0	1	0	1	2
OG0012633	0	0	0	0	1	0	1	2
OG0012634	0	0	0	0	1	0	1	2
OG0012635	0	0	0	0	1	0	1	2
OG0012636	0	0	0	0	1	0	1	2
OG0012637	0	0	0	0	1	0	1	2
OG0012638	0	0	0	0	1	0	1	2
OG0012639	0	0	0	0	1	0	1	2
OG0012640	0	0	0	0	1	0	1	2
OG0012641	0	0	0	0	1	0	1	2
OG0012642	0	0	0	0	1	0	1	2
OG0012643	0	0	0	0	1	0	1	2
OG0012644	0	0	0	0	1	0	1	2
OG0012645	0	0	0	0	1	0	1	2
OG0012646	0	0	0	0	1	0	1	2
OG0012647	0	0	0	0	1	0	1	2
OG0012648	0	0	0	0	1	0	1	2
OG0012649	0	0	0	0	1	0	1	2
OG0012650	0	0	0	0	1	0	1	2
OG0012651	0	0	0	0	1	0	1	2
OG0012652	0	0	0	0	1	0	1	2
OG0012653	0	0	0	0	1	0	1	2
OG0012654	0	0	0	0	1	0	1	2
OG0012655	0	0	0	0	1	0	1	2
OG0012656	0	0	0	0	1	0	1	2
OG0012657	0	0	0	0	1	0	1	2
OG0012658	0	0	0	0	1	0	1	2
OG0012659	0	0	0	0	1	0	1	2
OG0012660	0	0	0	0	1	0	1	2
OG0012661	0	0	0	0	1	0	1	2
OG0012662	0	0	0	0	1	0	1	2
OG0012663	0	0	0	0	1	0	1	2
OG0012664	0	0	0	0	1	0	1	2
OG0012665	0	0	0	0	1	0	1	2
OG0012666	0	0	0	0	1	0	1	2
OG0012667	0	0	0	0	1	0	1	2
OG0012668	0	0	0	0	1	0	1	2
OG0012669	0	0	0	0	1	0	1	2
OG0012670	0	0	0	0	1	0	1	2
OG0012671	0	0	0	0	0	2	0	2
OG0012672	0	0	0	0	0	2	0	2
OG0012673	0	0	0	0	0	2	0	2
OG0012674	0	0	0	0	0	2	0	2
OG0012675	0	0	0	0	0	2	0	2
OG0012676	0	0	0	0	0	1	1	2
OG0012677	0	0	0	0	0	1	1	2
OG0012678	0	0	0	0	0	2	0	2
OG0012679	0	0	0	0	0	2	0	2
OG0012680	0	0	0	0	0	2	0	2
OG0012681	0	0	0	0	0	2	0	2
OG0012682	0	0	0	0	0	2	0	2
OG0012683	0	0	0	0	0	1	1	2
OG0012684	0	0	0	0	0	2	0	2
OG0012685	0	0	0	0	0	2	0	2
OG0012686	0	0	0	0	0	1	1	2
OG0012687	0	0	0	0	0	2	0	2
OG0012688	0	0	0	0	0	2	0	2
OG0012689	0	0	0	0	0	2	0	2
OG0012690	0	0	0	0	0	2	0	2
OG0012691	0	0	0	0	0	2	0	2
OG0012692	0	0	0	0	0	2	0	2
OG0012693	0	0	0	0	0	2	0	2
OG0012694	0	0	0	0	0	2	0	2
OG0012695	0	0	0	0	0	2	0	2
OG0012696	0	0	0	0	0	2	0	2
OG0012697	0	0	0	0	0	2	0	2
OG0012698	0	0	0	0	0	2	0	2
OG0012699	0	0	0	0	0	2	0	2
OG0012700	0	0	0	0	0	2	0	2
OG0012701	0	0	0	0	0	2	0	2
OG0012702	0	0	0	0	0	2	0	2
OG0012703	0	0	0	0	0	2	0	2
OG0012704	0	0	0	0	0	2	0	2
OG0012705	0	0	0	0	0	2	0	2
OG0012706	0	0	0	0	0	2	0	2
OG0012707	0	0	0	0	0	2	0	2
OG0012708	0	0	0	0	0	2	0	2
OG0012709	0	0	0	0	0	2	0	2
OG0012710	0	0	0	0	0	2	0	2
OG0012711	0	0	0	0	0	2	0	2
OG0012712	0	0	0	0	0	2	0	2
OG0012713	0	0	0	0	0	2	0	2
OG0012714	0	0	0	0	0	2	0	2
OG0012715	0	0	0	0	0	2	0	2
OG0012716	0	0	0	0	0	2	0	2
OG0012717	0	0	0	0	0	2	0	2
OG0012718	0	0	0	0	0	2	0	2
OG0012719	0	0	0	0	0	2	0	2
OG0012720	0	0	0	0	0	2	0	2
OG0012721	0	0	0	0	0	1	1	2
OG0012722	0	0	0	0	0	2	0	2
OG0012723	0	0	0	0	0	2	0	2
OG0012724	0	0	0	0	0	2	0	2
OG0012725	0	0	0	0	0	2	0	2
OG0012726	0	0	0	0	0	2	0	2
OG0012727	0	0	0	0	0	2	0	2
OG0012728	0	0	0	0	0	2	0	2
OG0012729	0	0	0	0	0	2	0	2
OG0012730	0	0	0	0	0	2	0	2
OG0012731	0	0	0	0	0	2	0	2
OG0012732	0	0	0	0	0	2	0	2
OG0012733	0	0	0	0	0	2	0	2
OG0012734	0	0	0	0	0	2	0	2
OG0012735	0	0	0	0	0	2	0	2
OG0012736	0	0	0	0	0	2	0	2
OG0012737	0	0	0	0	0	2	0	2
OG0012738	0	0	0	0	0	2	0	2
OG0012739	0	0	0	0	0	2	0	2
OG0012740	0	0	0	0	0	1	1	2
OG0012741	0	0	0	0	0	1	1	2
OG0012742	0	0	0	0	0	2	0	2
OG0012743	0	0	0	0	0	1	1	2
OG0012744	0	0	0	0	0	2	0	2
OG0012745	0	0	0	0	0	2	0	2
OG0012746	0	0	0	0	0	2	0	2
OG0012747	0	0	0	0	0	2	0	2
OG0012748	0	0	0	0	0	2	0	2
OG0012749	0	0	0	0	0	2	0	2
OG0012750	0	0	0	0	0	2	0	2
OG0012751	0	0	0	0	0	2	0	2
OG0012752	0	0	0	0	0	2	0	2
OG0012753	0	0	0	0	0	2	0	2
OG0012754	0	0	0	0	0	2	0	2
OG0012755	0	0	0	0	0	2	0	2
OG0012756	0	0	0	0	0	2	0	2
OG0012757	0	0	0	0	0	2	0	2
OG0012758	0	0	0	0	0	2	0	2
OG0012759	0	0	0	0	0	2	0	2
OG0012760	0	0	0	0	0	1	1	2
OG0012761	0	0	0	0	0	2	0	2
OG0012762	0	0	0	0	0	2	0	2
OG0012763	0	0	0	0	0	2	0	2
OG0012764	0	0	0	0	0	2	0	2
OG0012765	0	0	0	0	0	2	0	2
OG0012766	0	0	0	0	0	2	0	2
OG0012767	0	0	0	0	0	2	0	2
OG0012768	0	0	0	0	0	2	0	2
OG0012769	0	0	0	0	0	2	0	2
OG0012770	0	0	0	0	0	2	0	2
OG0012771	0	0	0	0	0	1	1	2
OG0012772	0	0	0	0	0	2	0	2
OG0012773	0	0	0	0	0	2	0	2
OG0012774	0	0	0	0	0	2	0	2
OG0012775	0	0	0	0	0	1	1	2
OG0012776	0	0	0	0	0	2	0	2
OG0012777	0	0	0	0	0	2	0	2
OG0012778	0	0	0	0	0	2	0	2
OG0012779	0	0	0	0	0	2	0	2
OG0012780	0	0	0	0	0	2	0	2
OG0012781	0	0	0	0	0	2	0	2
OG0012782	0	0	0	0	0	2	0	2
OG0012783	0	0	0	0	0	2	0	2
OG0012784	0	0	0	0	0	2	0	2
OG0012785	0	0	0	0	0	2	0	2
OG0012786	0	0	0	0	0	2	0	2
OG0012787	0	0	0	0	0	2	0	2
OG0012788	0	0	0	0	0	2	0	2
OG0012789	0	0	0	0	0	1	1	2
OG0012790	0	0	0	0	0	2	0	2
OG0012791	0	0	0	0	0	1	1	2
OG0012792	0	0	0	0	0	2	0	2
OG0012793	0	0	0	0	0	2	0	2
OG0012794	0	0	0	0	0	2	0	2
OG0012795	0	0	0	0	0	2	0	2
OG0012796	0	0	0	0	0	2	0	2
OG0012797	0	0	0	0	0	2	0	2
OG0012798	0	0	0	0	0	2	0	2
OG0012799	0	0	0	0	0	2	0	2
OG0012800	0	0	0	0	0	1	1	2
OG0012801	0	0	0	0	0	2	0	2
OG0012802	0	0	0	0	0	2	0	2
OG0012803	0	0	0	0	0	2	0	2
OG0012804	0	0	0	0	0	2	0	2
OG0012805	0	0	0	0	0	1	1	2
OG0012806	0	0	0	0	0	2	0	2
OG0012807	0	0	0	0	0	2	0	2
OG0012808	0	0	0	0	0	2	0	2
OG0012809	0	0	0	0	0	2	0	2
OG0012810	0	0	0	0	0	2	0	2
OG0012811	0	0	0	0	0	2	0	2
OG0012812	0	0	0	0	0	2	0	2
OG0012813	0	0	0	0	0	2	0	2
OG0012814	0	0	0	0	0	2	0	2
OG0012815	0	0	0	0	0	1	1	2
OG0012816	0	0	0	0	0	1	1	2
OG0012817	0	0	0	0	0	2	0	2
OG0012818	0	0	0	0	0	2	0	2
OG0012819	0	0	0	0	0	2	0	2
OG0012820	0	0	0	0	0	2	0	2
OG0012821	0	0	0	0	0	2	0	2
OG0012822	0	0	0	0	0	2	0	2
OG0012823	0	0	0	0	0	2	0	2
OG0012824	0	0	0	0	0	2	0	2
OG0012825	0	0	0	0	0	2	0	2
OG0012826	0	0	0	0	0	2	0	2
OG0012827	0	0	0	0	0	2	0	2
OG0012828	0	0	0	0	0	2	0	2
OG0012829	0	0	0	0	0	2	0	2
OG0012830	0	0	0	0	0	2	0	2
OG0012831	0	0	0	0	0	2	0	2
OG0012832	0	0	0	0	0	2	0	2
OG0012833	0	0	0	0	0	2	0	2
OG0012834	0	0	0	0	0	2	0	2
OG0012835	0	0	0	0	0	2	0	2
OG0012836	0	0	0	0	0	2	0	2
OG0012837	0	0	0	0	0	2	0	2
OG0012838	0	0	0	0	0	2	0	2
OG0012839	0	0	0	0	0	2	0	2
OG0012840	0	0	0	0	0	2	0	2
OG0012841	0	0	0	0	0	2	0	2
OG0012842	0	0	0	0	0	2	0	2
OG0012843	0	0	0	0	0	2	0	2
OG0012844	0	0	0	0	0	2	0	2
OG0012845	0	0	0	0	0	2	0	2
OG0012846	0	0	0	0	0	2	0	2
OG0012847	0	0	0	0	0	2	0	2
OG0012848	0	0	0	0	0	2	0	2
OG0012849	0	0	0	0	0	2	0	2
OG0012850	0	0	0	0	0	2	0	2
OG0012851	0	0	0	0	0	2	0	2
OG0012852	0	0	0	0	0	1	1	2
OG0012853	0	0	0	0	0	2	0	2
OG0012854	0	0	0	0	0	2	0	2
OG0012855	0	0	0	0	0	2	0	2
OG0012856	0	0	0	0	0	2	0	2
OG0012857	0	0	0	0	0	2	0	2
OG0012858	0	0	0	0	0	2	0	2
OG0012859	0	0	0	0	0	2	0	2
OG0012860	0	0	0	0	0	2	0	2
OG0012861	0	0	0	0	0	2	0	2
OG0012862	0	0	0	0	0	2	0	2
OG0012863	0	0	0	0	0	1	1	2
OG0012864	0	0	0	0	0	2	0	2
OG0012865	0	0	0	0	0	2	0	2
OG0012866	0	0	0	0	0	2	0	2
OG0012867	0	0	0	0	0	2	0	2
OG0012868	0	0	0	0	0	2	0	2
OG0012869	0	0	0	0	0	2	0	2
OG0012870	0	0	0	0	0	1	1	2
OG0012871	0	0	0	0	0	1	1	2
OG0012872	0	0	0	0	0	2	0	2
OG0012873	0	0	0	0	0	2	0	2
OG0012874	0	0	0	0	0	2	0	2
OG0012875	0	0	0	0	0	2	0	2
OG0012876	0	0	0	0	0	1	1	2
OG0012877	0	0	0	0	0	1	1	2
OG0012878	0	0	0	0	0	2	0	2
OG0012879	0	0	0	0	0	2	0	2
OG0012880	0	0	0	0	0	2	0	2
OG0012881	0	0	0	0	0	2	0	2
OG0012882	0	0	0	0	0	2	0	2
OG0012883	0	0	0	0	0	2	0	2
OG0012884	0	0	0	0	0	2	0	2
OG0012885	0	0	0	0	0	2	0	2
OG0012886	0	0	0	0	0	2	0	2
OG0012887	0	0	0	0	0	2	0	2
OG0012888	0	0	0	0	0	1	1	2
OG0012889	0	0	0	0	0	2	0	2
OG0012890	0	0	0	0	0	2	0	2
OG0012891	0	0	0	0	0	2	0	2
OG0012892	0	0	0	0	0	2	0	2
OG0012893	0	0	0	0	0	1	1	2
OG0012894	0	0	0	0	0	2	0	2
OG0012895	0	0	0	0	0	2	0	2
OG0012896	0	0	0	0	0	2	0	2
OG0012897	0	0	0	0	0	2	0	2
OG0012898	0	0	0	0	0	2	0	2
OG0012899	0	0	0	0	0	2	0	2
OG0012900	0	0	0	0	0	2	0	2
OG0012901	0	0	0	0	0	2	0	2
OG0012902	0	0	0	0	0	2	0	2
OG0012903	0	0	0	0	0	1	1	2
OG0012904	0	0	0	0	0	2	0	2
OG0012905	0	0	0	0	0	2	0	2
OG0012906	0	0	0	0	0	2	0	2
OG0012907	0	0	0	0	0	2	0	2
OG0012908	0	0	0	0	0	2	0	2
OG0012909	0	0	0	0	0	2	0	2
OG0012910	0	0	0	0	0	2	0	2
OG0012911	0	0	0	0	0	1	1	2
OG0012912	0	0	0	0	0	2	0	2
OG0012913	0	0	0	0	0	2	0	2
OG0012914	0	0	0	0	0	2	0	2
OG0012915	0	0	0	0	0	2	0	2
OG0012916	0	0	0	0	0	2	0	2
OG0012917	0	0	0	0	0	2	0	2
OG0012918	0	0	0	0	0	2	0	2
OG0012919	0	0	0	0	0	2	0	2
OG0012920	0	0	0	0	0	2	0	2
OG0012921	0	0	0	0	0	2	0	2
OG0012922	0	0	0	0	0	2	0	2
OG0012923	0	0	0	0	0	2	0	2
OG0012924	0	0	0	0	0	2	0	2
OG0012925	0	0	0	0	0	2	0	2
OG0012926	0	0	0	0	0	2	0	2
OG0012927	0	0	0	0	0	1	1	2
OG0012928	0	0	0	0	0	2	0	2
OG0012929	0	0	0	0	0	2	0	2
OG0012930	0	0	0	0	0	2	0	2
OG0012931	0	0	0	0	0	1	1	2
OG0012932	0	0	0	0	0	2	0	2
OG0012933	0	0	0	0	0	2	0	2
OG0012934	0	0	0	0	0	2	0	2
OG0012935	0	0	0	0	0	2	0	2
OG0012936	0	0	0	0	0	1	1	2
OG0012937	0	0	0	0	0	2	0	2
OG0012938	0	0	0	0	0	1	1	2
OG0012939	0	0	0	0	0	1	1	2
OG0012940	0	0	0	0	0	2	0	2
OG0012941	0	0	0	0	0	2	0	2
OG0012942	0	0	0	0	0	2	0	2
OG0012943	0	0	0	0	0	2	0	2
OG0012944	0	0	0	0	0	2	0	2
OG0012945	0	0	0	0	0	2	0	2
OG0012946	0	0	0	0	0	2	0	2
OG0012947	0	0	0	0	0	2	0	2
OG0012948	0	0	0	0	0	1	1	2
OG0012949	0	0	0	0	0	2	0	2
OG0012950	0	0	0	0	0	2	0	2
OG0012951	0	0	0	0	0	2	0	2
OG0012952	0	0	0	0	0	2	0	2
OG0012953	0	0	0	0	0	2	0	2
OG0012954	0	0	0	0	0	2	0	2
OG0012955	0	0	0	0	0	2	0	2
OG0012956	0	0	0	0	0	2	0	2
OG0012957	0	0	0	0	0	2	0	2
OG0012958	0	0	0	0	0	2	0	2
OG0012959	0	0	0	0	0	1	1	2
OG0012960	0	0	0	0	0	2	0	2
OG0012961	0	0	0	0	0	2	0	2
OG0012962	0	0	0	0	0	1	1	2
OG0012963	0	0	0	0	0	2	0	2
OG0012964	0	0	0	0	0	2	0	2
OG0012965	0	0	0	0	0	1	1	2
OG0012966	0	0	0	0	0	1	1	2
OG0012967	0	0	0	0	0	2	0	2
OG0012968	0	0	0	0	0	2	0	2
OG0012969	0	0	0	0	0	2	0	2
OG0012970	0	0	0	0	0	2	0	2
OG0012971	0	0	0	0	0	1	1	2
OG0012972	0	0	0	0	0	2	0	2
OG0012973	0	0	0	0	0	2	0	2
OG0012974	0	0	0	0	0	2	0	2
OG0012975	0	0	0	0	0	2	0	2
OG0012976	0	0	0	0	0	2	0	2
OG0012977	0	0	0	0	0	2	0	2
OG0012978	0	0	0	0	0	1	1	2
OG0012979	0	0	0	0	0	2	0	2
OG0012980	0	0	0	0	0	2	0	2
OG0012981	0	0	0	0	0	2	0	2
OG0012982	0	0	0	0	0	2	0	2
OG0012983	0	0	0	0	0	2	0	2
OG0012984	0	0	0	0	0	2	0	2
OG0012985	0	0	0	0	0	2	0	2
OG0012986	0	0	0	0	0	2	0	2
OG0012987	0	0	0	0	0	2	0	2
OG0012988	0	0	0	0	0	2	0	2
OG0012989	0	0	0	0	0	2	0	2
OG0012990	0	0	0	0	0	2	0	2
OG0012991	0	0	0	0	0	1	1	2
OG0012992	0	0	0	0	0	1	1	2
OG0012993	0	0	0	0	0	2	0	2
OG0012994	0	0	0	0	0	1	1	2
OG0012995	0	0	0	0	0	0	2	2
OG0012996	0	0	0	0	0	0	2	2
OG0012997	0	0	0	0	0	0	2	2
OG0012998	0	0	0	0	0	0	2	2
OG0012999	0	0	0	0	0	0	2	2
OG0013000	0	0	0	0	0	0	2	2
OG0013001	0	0	0	0	0	0	2	2
OG0013002	0	0	0	0	0	0	2	2
OG0013003	0	0	0	0	0	0	2	2
OG0013004	0	0	0	0	0	0	2	2
OG0013005	0	0	0	0	0	0	2	2
OG0013006	0	0	0	0	0	0	2	2
OG0013007	0	0	0	0	0	0	2	2
OG0013008	0	0	0	0	0	0	2	2
OG0013009	0	0	0	0	0	0	2	2
OG0013010	0	0	0	0	0	0	2	2
OG0013011	0	0	0	0	0	0	2	2
OG0013012	0	0	0	0	0	0	2	2
OG0013013	0	0	0	0	0	0	2	2
OG0013014	0	0	0	0	0	0	2	2
OG0013015	0	0	0	0	0	0	2	2
OG0013016	0	0	0	0	0	0	2	2
OG0013017	0	0	0	0	0	0	2	2
OG0013018	0	0	0	0	0	0	2	2
OG0013019	0	0	0	0	0	0	2	2
OG0013020	0	0	0	0	0	0	2	2
OG0013021	0	0	0	0	0	0	2	2
OG0013022	0	0	0	0	0	0	2	2
OG0013023	0	0	0	0	0	0	2	2
OG0013024	0	0	0	0	0	0	2	2
OG0013025	0	0	0	0	0	0	2	2
OG0013026	0	0	0	0	0	0	2	2
OG0013027	0	0	0	0	0	0	2	2
OG0013028	0	0	0	0	0	0	2	2
OG0013029	0	0	0	0	0	0	2	2
OG0013030	0	0	0	0	0	0	2	2
OG0013031	0	0	0	0	0	0	2	2
OG0013032	0	0	0	0	0	0	2	2
OG0013033	0	0	0	0	0	0	2	2
OG0013034	0	0	0	0	0	0	2	2
OG0013035	0	0	0	0	0	0	2	2
OG0013036	0	0	0	0	0	0	2	2
OG0013037	0	0	0	0	0	0	2	2
OG0013038	0	0	0	0	0	0	2	2
OG0013039	0	0	0	0	0	0	2	2
OG0013040	0	0	0	0	0	0	2	2
OG0013041	0	0	0	0	0	0	2	2
OG0013042	0	0	0	0	0	0	2	2
OG0013043	0	0	0	0	0	0	2	2
OG0013044	0	0	0	0	0	0	2	2
OG0013045	0	0	0	0	0	0	2	2
OG0013046	0	0	0	0	0	0	2	2
OG0013047	0	0	0	0	0	0	2	2
OG0013048	0	0	0	0	0	0	2	2
OG0013049	0	0	0	0	0	0	2	2
OG0013050	0	0	0	0	0	0	2	2
OG0013051	0	0	0	0	0	0	2	2
OG0013052	0	0	0	0	0	0	2	2
OG0013053	0	0	0	0	0	0	2	2
OG0013054	0	0	0	0	0	0	2	2
OG0013055	0	0	0	0	0	0	2	2
OG0013056	0	0	0	0	0	0	2	2
OG0013057	0	0	0	0	0	0	2	2
OG0013058	0	0	0	0	0	0	2	2
OG0013059	0	0	0	0	0	0	2	2
OG0013060	0	0	0	0	0	0	2	2
OG0013061	0	0	0	0	0	0	2	2
OG0013062	0	0	0	0	0	0	2	2
OG0013063	0	0	0	0	0	0	2	2
OG0013064	0	0	0	0	0	0	2	2
OG0013065	0	0	0	0	0	0	2	2
OG0013066	0	0	0	0	0	0	2	2
OG0013067	0	0	0	0	0	0	2	2
OG0013068	0	0	0	0	0	0	2	2
OG0013069	0	0	0	0	0	0	2	2
OG0013070	0	0	0	0	0	0	2	2
OG0013071	0	0	0	0	0	0	2	2
OG0013072	0	0	0	0	0	0	2	2
OG0013073	0	0	0	0	0	0	2	2
OG0013074	0	0	0	0	0	0	2	2
OG0013075	0	0	0	0	0	0	2	2
OG0013076	0	0	0	0	0	0	2	2
OG0013077	0	0	0	0	0	0	2	2
OG0013078	0	0	0	0	0	0	2	2
OG0013079	0	0	0	0	0	0	2	2
OG0013080	0	0	0	0	0	0	2	2
OG0013081	0	0	0	0	0	0	2	2
OG0013082	0	0	0	0	0	0	2	2
OG0013083	0	0	0	0	0	0	2	2
OG0013084	0	0	0	0	0	0	2	2
OG0013085	0	0	0	0	0	0	2	2
OG0013086	0	0	0	0	0	0	2	2
OG0013087	0	0	0	0	0	0	2	2
OG0013088	0	0	0	0	0	0	2	2
OG0013089	0	0	0	0	0	0	2	2
OG0013090	0	0	0	0	0	0	2	2
OG0013091	0	0	0	0	0	0	2	2
OG0013092	0	0	0	0	0	0	2	2
OG0013093	0	0	0	0	0	0	2	2
OG0013094	0	0	0	0	0	0	2	2
OG0013095	0	0	0	0	0	0	2	2
OG0013096	0	0	0	0	0	0	2	2
OG0013097	0	0	0	0	0	0	2	2
OG0013098	0	0	0	0	0	0	2	2
OG0013099	0	0	0	0	0	0	2	2
OG0013100	0	0	0	0	0	0	2	2
OG0013101	0	0	0	0	0	0	2	2
OG0013102	0	0	0	0	0	0	2	2
OG0013103	0	0	0	0	0	0	2	2
OG0013104	0	0	0	0	0	0	2	2
OG0013105	0	0	0	0	0	0	2	2
OG0013106	0	0	0	0	0	0	2	2
OG0013107	0	0	0	0	0	0	2	2
OG0013108	0	0	0	0	0	0	2	2
OG0013109	0	0	0	0	0	0	2	2
OG0013110	0	0	0	0	0	0	2	2
OG0013111	0	0	0	0	0	0	2	2
OG0013112	0	0	0	0	0	0	2	2
OG0013113	0	0	0	0	0	0	2	2
OG0013114	0	0	0	0	0	0	2	2
OG0013115	0	0	0	0	0	0	2	2
OG0013116	0	0	0	0	0	0	2	2
OG0013117	0	0	0	0	0	0	2	2
OG0013118	0	0	0	0	0	0	2	2
OG0013119	0	0	0	0	0	0	2	2
OG0013120	0	0	0	0	0	0	2	2
OG0013121	0	0	0	0	0	0	2	2
OG0013122	0	0	0	0	0	0	2	2
OG0013123	0	0	0	0	0	0	2	2
OG0013124	0	0	0	0	0	0	2	2
OG0013125	0	0	0	0	0	0	2	2
OG0013126	0	0	0	0	0	0	2	2
OG0013127	0	0	0	0	0	0	2	2
OG0013128	0	0	0	0	0	0	2	2
OG0013129	0	0	0	0	0	0	2	2
OG0013130	0	0	0	0	0	0	2	2
OG0013131	0	0	0	0	0	0	2	2
OG0013132	0	0	0	0	0	0	2	2
OG0013133	0	0	0	0	0	0	2	2
OG0013134	0	0	0	0	0	0	2	2
OG0013135	0	0	0	0	0	0	2	2
OG0013136	0	0	0	0	0	0	2	2
OG0013137	0	0	0	0	0	0	2	2
OG0013138	0	0	0	0	0	0	2	2
OG0013139	0	0	0	0	0	0	2	2
OG0013140	0	0	0	0	0	0	2	2
OG0013141	0	0	0	0	0	0	2	2
OG0013142	0	0	0	0	0	0	2	2
OG0013143	0	0	0	0	0	0	2	2
OG0013144	0	0	0	0	0	0	2	2
OG0013145	0	0	0	0	0	0	2	2
OG0013146	0	0	0	0	0	0	2	2
OG0013147	0	0	0	0	0	0	2	2
OG0013148	0	0	0	0	0	0	2	2
OG0013149	0	0	0	0	0	0	2	2
OG0013150	0	0	0	0	0	0	2	2
OG0013151	0	0	0	0	0	0	2	2
OG0013152	0	0	0	0	0	0	2	2
OG0013153	0	0	0	0	0	0	2	2
OG0013154	0	0	0	0	0	0	2	2
OG0013155	0	0	0	0	0	0	2	2
OG0013156	0	0	0	0	0	0	2	2
OG0013157	0	0	0	0	0	0	2	2
OG0013158	0	0	0	0	0	0	2	2
OG0013159	0	0	0	0	0	0	2	2
OG0013160	0	0	0	0	0	0	2	2
OG0013161	0	0	0	0	0	0	2	2
OG0013162	0	0	0	0	0	0	2	2
OG0013163	0	0	0	0	0	0	2	2
OG0013164	0	0	0	0	0	0	2	2
OG0013165	0	0	0	0	0	0	2	2
OG0013166	0	0	0	0	0	0	2	2
OG0013167	0	0	0	0	0	0	2	2
OG0013168	0	0	0	0	0	0	2	2
OG0013169	0	0	0	0	0	0	2	2
OG0013170	0	0	0	0	0	0	2	2
OG0013171	0	0	0	0	0	0	2	2
OG0013172	0	0	0	0	0	0	2	2
OG0013173	0	0	0	0	0	0	2	2
OG0013174	0	0	0	0	0	0	2	2
OG0013175	0	0	0	0	0	0	2	2
OG0013176	0	0	0	0	0	0	2	2
OG0013177	0	0	0	0	0	0	2	2
OG0013178	0	0	0	0	0	0	2	2
OG0013179	0	0	0	0	0	0	2	2
OG0013180	0	0	0	0	0	0	2	2
OG0013181	0	0	0	0	0	0	2	2
OG0013182	0	0	0	0	0	0	2	2
OG0013183	0	0	0	0	0	0	2	2
OG0013184	0	0	0	0	0	0	2	2
OG0013185	0	0	0	0	0	0	2	2
OG0013186	0	0	0	0	0	0	2	2
OG0013187	0	0	0	0	0	0	2	2
OG0013188	0	0	0	0	0	0	2	2
OG0013189	0	0	0	0	0	0	2	2
OG0013190	0	0	0	0	0	0	2	2
OG0013191	0	0	0	0	0	0	2	2
OG0013192	0	0	0	0	0	0	2	2
OG0013193	0	0	0	0	0	0	2	2
OG0013194	0	0	0	0	0	0	2	2
OG0013195	0	0	0	0	0	0	2	2
OG0013196	0	0	0	0	0	0	2	2
OG0013197	0	0	0	0	0	0	2	2
OG0013198	0	0	0	0	0	0	2	2
OG0013199	0	0	0	0	0	0	2	2
OG0013200	0	0	0	0	0	0	2	2
OG0013201	0	0	0	0	0	0	2	2
OG0013202	0	0	0	0	0	0	2	2
OG0013203	0	0	0	0	0	0	2	2
OG0013204	0	0	0	0	0	0	2	2
OG0013205	0	0	0	0	0	0	2	2
OG0013206	0	0	0	0	0	0	2	2
OG0013207	0	0	0	0	0	0	2	2
OG0013208	0	0	0	0	0	0	2	2
OG0013209	0	0	0	0	0	0	2	2
OG0013210	0	0	0	0	0	0	2	2
OG0013211	0	0	0	0	0	0	2	2
OG0013212	0	0	0	0	0	0	2	2
OG0013213	0	0	0	0	0	0	2	2
OG0013214	0	0	0	0	0	0	2	2
OG0013215	0	0	0	0	0	0	2	2
OG0013216	0	0	0	0	0	0	2	2
OG0013217	0	0	0	0	0	0	2	2
OG0013218	0	0	0	0	0	0	2	2
OG0013219	0	0	0	0	0	0	2	2
OG0013220	0	0	0	0	0	0	2	2
OG0013221	0	0	0	0	0	0	2	2
OG0013222	0	0	0	0	0	0	2	2
OG0013223	0	0	0	0	0	0	2	2
OG0013224	0	0	0	0	0	0	2	2
OG0013225	0	0	0	0	0	0	2	2
OG0013226	0	0	0	0	0	0	2	2
OG0013227	0	0	0	0	0	0	2	2
OG0013228	0	0	0	0	0	0	2	2
OG0013229	0	0	0	0	0	0	2	2
OG0013230	0	0	0	0	0	0	2	2
OG0013231	0	0	0	0	0	0	2	2
OG0013232	0	0	0	0	0	0	2	2
OG0013233	0	0	0	0	0	0	2	2
OG0013234	0	0	0	0	0	0	2	2
OG0013235	0	0	0	0	0	0	2	2
OG0013236	0	0	0	0	0	0	2	2
OG0013237	0	0	0	0	0	0	2	2
OG0013238	0	0	0	0	0	0	2	2
OG0013239	0	0	0	0	0	0	2	2
OG0013240	0	0	0	0	0	0	2	2
OG0013241	0	0	0	0	0	0	2	2
OG0013242	0	0	0	0	0	0	2	2
OG0013243	0	0	0	0	0	0	2	2
OG0013244	0	0	0	0	0	0	2	2
OG0013245	0	0	0	0	0	0	2	2
OG0013246	0	0	0	0	0	0	2	2
OG0013247	0	0	0	0	0	0	2	2
OG0013248	0	0	0	0	0	0	2	2
OG0013249	0	0	0	0	0	0	2	2
OG0013250	0	0	0	0	0	0	2	2
OG0013251	0	0	0	0	0	0	2	2
OG0013252	0	0	0	0	0	0	2	2
OG0013253	0	0	0	0	0	0	2	2
OG0013254	0	0	0	0	0	0	2	2
OG0013255	0	0	0	0	0	0	2	2
OG0013256	0	0	0	0	0	0	2	2
OG0013257	0	0	0	0	0	0	2	2
OG0013258	0	0	0	0	0	0	2	2
OG0013259	0	0	0	0	0	0	2	2
OG0013260	0	0	0	0	0	0	2	2
OG0013261	0	0	0	0	0	0	2	2
OG0013262	0	0	0	0	0	0	2	2
OG0013263	0	0	0	0	0	0	2	2
OG0013264	0	0	0	0	0	0	2	2
OG0013265	0	0	0	0	0	0	2	2
OG0013266	0	0	0	0	0	0	2	2
OG0013267	0	0	0	0	0	0	2	2
OG0013268	0	0	0	0	0	0	2	2
OG0013269	0	0	0	0	0	0	2	2
OG0013270	0	0	0	0	0	0	2	2
OG0013271	0	0	0	0	0	0	2	2
OG0013272	0	0	0	0	0	0	2	2
OG0013273	0	0	0	0	0	0	2	2
OG0013274	0	0	0	0	0	0	2	2
OG0013275	0	0	0	0	0	0	2	2
OG0013276	0	0	0	0	0	0	2	2
OG0013277	0	0	0	0	0	0	2	2
OG0013278	0	0	0	0	0	0	2	2
OG0013279	0	0	0	0	0	0	2	2
OG0013280	0	0	0	0	0	0	2	2
OG0013281	0	0	0	0	0	0	2	2
OG0013282	0	0	0	0	0	0	2	2
OG0013283	0	0	0	0	0	0	2	2
OG0013284	0	0	0	0	0	0	2	2
OG0013285	0	0	0	0	0	0	2	2
OG0013286	0	0	0	0	0	0	2	2
OG0013287	0	0	0	0	0	0	2	2
OG0013288	0	0	0	0	0	0	2	2
OG0013289	0	0	0	0	0	0	2	2
OG0013290	0	0	0	0	0	0	2	2
OG0013291	0	0	0	0	0	0	2	2
OG0013292	0	0	0	0	0	0	2	2
OG0013293	0	0	0	0	0	0	2	2
OG0013294	0	0	0	0	0	0	2	2
OG0013295	0	0	0	0	0	0	2	2
OG0013296	0	0	0	0	0	0	2	2
OG0013297	0	0	0	0	0	0	2	2
OG0013298	0	0	0	0	0	0	2	2
OG0013299	0	0	0	0	0	0	2	2
OG0013300	0	0	0	0	0	0	2	2
OG0013301	0	0	0	0	0	0	2	2
OG0013302	0	0	0	0	0	0	2	2
OG0013303	0	0	0	0	0	0	2	2
OG0013304	0	0	0	0	0	0	2	2
OG0013305	0	0	0	0	0	0	2	2
OG0013306	0	0	0	0	0	0	2	2
OG0013307	0	0	0	0	0	0	2	2
OG0013308	0	0	0	0	0	0	2	2
OG0013309	0	0	0	0	0	0	2	2
OG0013310	0	0	0	0	0	0	2	2
OG0013311	0	0	0	0	0	0	2	2
OG0013312	0	0	0	0	0	0	2	2
OG0013313	0	0	0	0	0	0	2	2
OG0013314	0	0	0	0	0	0	2	2
OG0013315	0	0	0	0	0	0	2	2
OG0013316	0	0	0	0	0	0	2	2
OG0013317	0	0	0	0	0	0	2	2
OG0013318	0	0	0	0	0	0	2	2
OG0013319	0	0	0	0	0	0	2	2
OG0013320	0	0	0	0	0	0	2	2
OG0013321	0	0	0	0	0	0	2	2
OG0013322	0	0	0	0	0	0	2	2
OG0013323	0	0	0	0	0	0	2	2
OG0013324	0	0	0	0	0	0	2	2
OG0013325	0	0	0	0	0	0	2	2
OG0013326	0	0	0	0	0	0	2	2
OG0013327	0	0	0	0	0	0	2	2
OG0013328	0	0	0	0	0	0	2	2
OG0013329	0	0	0	0	0	0	2	2
OG0013330	0	0	0	0	0	0	2	2
OG0013331	0	0	0	0	0	0	2	2
OG0013332	0	0	0	0	0	0	2	2
OG0013333	0	0	0	0	0	0	2	2
OG0013334	0	0	0	0	0	0	2	2
OG0013335	0	0	0	0	0	0	2	2
OG0013336	0	0	0	0	0	0	2	2
OG0013337	0	0	0	0	0	0	2	2
OG0013338	0	0	0	0	0	0	2	2
OG0013339	0	0	0	0	0	0	2	2
OG0013340	0	0	0	0	0	0	2	2
OG0013341	0	0	0	0	0	0	2	2
OG0013342	0	0	0	0	0	0	2	2
OG0013343	0	0	0	0	0	0	2	2
OG0013344	0	0	0	0	0	0	2	2
OG0013345	0	0	0	0	0	0	2	2
OG0013346	0	0	0	0	0	0	2	2
OG0013347	0	0	0	0	0	0	2	2
OG0013348	0	0	0	0	0	0	2	2
OG0013349	0	0	0	0	0	0	2	2
OG0013350	0	0	0	0	0	0	2	2
OG0013351	0	0	0	0	0	0	2	2
OG0013352	0	0	0	0	0	0	2	2
OG0013353	0	0	0	0	0	0	2	2
OG0013354	0	0	0	0	0	0	2	2
OG0013355	0	0	0	0	0	0	2	2
OG0013356	0	0	0	0	0	0	2	2
OG0013357	0	0	0	0	0	0	2	2
OG0013358	0	0	0	0	0	0	2	2
OG0013359	0	0	0	0	0	0	2	2
OG0013360	0	0	0	0	0	0	2	2
OG0013361	0	0	0	0	0	0	2	2
OG0013362	0	0	0	0	0	0	2	2
OG0013363	0	0	0	0	0	0	2	2
OG0013364	0	0	0	0	0	0	2	2
OG0013365	0	0	0	0	0	0	2	2
OG0013366	0	0	0	0	0	0	2	2
OG0013367	0	0	0	0	0	0	2	2
OG0013368	0	0	0	0	0	0	2	2
OG0013369	0	0	0	0	0	0	2	2
OG0013370	0	0	0	0	0	0	2	2
OG0013371	0	0	0	0	0	0	2	2
OG0013372	0	0	0	0	0	0	2	2
OG0013373	0	0	0	0	0	0	2	2
OG0013374	0	0	0	0	0	0	2	2
OG0013375	0	0	0	0	0	0	2	2
OG0013376	0	0	0	0	0	0	2	2
OG0013377	0	0	0	0	0	0	2	2
OG0013378	0	0	0	0	0	0	2	2
OG0013379	0	0	0	0	0	0	2	2
OG0013380	0	0	0	0	0	0	2	2
OG0013381	0	0	0	0	0	0	2	2
OG0013382	0	0	0	0	0	0	2	2
OG0013383	0	0	0	0	0	0	2	2
OG0013384	0	0	0	0	0	0	2	2
OG0013385	0	0	0	0	0	0	2	2
OG0013386	0	0	0	0	0	0	2	2
OG0013387	0	0	0	0	0	0	2	2
OG0013388	0	0	0	0	0	0	2	2
OG0013389	0	0	0	0	0	0	2	2
OG0013390	0	0	0	0	0	0	2	2
OG0013391	0	0	0	0	0	0	2	2
OG0013392	0	0	0	0	0	0	2	2
OG0013393	0	0	0	0	0	0	2	2
OG0013394	0	0	0	0	0	0	2	2
OG0013395	0	0	0	0	0	0	2	2
OG0013396	0	0	0	0	0	0	2	2
OG0013397	0	0	0	0	0	0	2	2
OG0013398	0	0	0	0	0	0	2	2
OG0013399	0	0	0	0	0	0	2	2
OG0013400	0	0	0	0	0	0	2	2
OG0013401	0	0	0	0	0	0	2	2
OG0013402	0	0	0	0	0	0	2	2
OG0013403	0	0	0	0	0	0	2	2
OG0013404	0	0	0	0	0	0	2	2
OG0013405	0	0	0	0	0	0	2	2
OG0013406	0	0	0	0	0	0	2	2
OG0013407	0	0	0	0	0	0	2	2
OG0013408	0	0	0	0	0	0	2	2
OG0013409	0	0	0	0	0	0	2	2
OG0013410	0	0	0	0	0	0	2	2
OG0013411	0	0	0	0	0	0	2	2
OG0013412	0	0	0	0	0	0	2	2
OG0013413	0	0	0	0	0	0	2	2
OG0013414	0	0	0	0	0	0	2	2
OG0013415	0	0	0	0	0	0	2	2
OG0013416	0	0	0	0	0	0	2	2
OG0013417	0	0	0	0	0	0	2	2
OG0013418	0	0	0	0	0	0	2	2
OG0013419	0	0	0	0	0	0	2	2
OG0013420	0	0	0	0	0	0	2	2
OG0013421	0	0	0	0	0	0	2	2
OG0013422	0	0	0	0	0	0	2	2
OG0013423	0	0	0	0	0	0	2	2
OG0013424	0	0	0	0	0	0	2	2
OG0013425	0	0	0	0	0	0	2	2
OG0013426	0	0	0	0	0	0	2	2
OG0013427	0	0	0	0	0	0	2	2
OG0013428	0	0	0	0	0	0	2	2
OG0013429	0	0	0	0	0	0	2	2
OG0013430	0	0	0	0	0	0	2	2
OG0013431	0	0	0	0	0	0	2	2
OG0013432	0	0	0	0	0	0	2	2
OG0013433	0	0	0	0	0	0	2	2
OG0013434	0	0	0	0	0	0	2	2
OG0013435	0	0	0	0	0	0	2	2
OG0013436	0	0	0	0	0	0	2	2
OG0013437	0	0	0	0	0	0	2	2
OG0013438	0	0	0	0	0	0	2	2
OG0013439	0	0	0	0	0	0	2	2
OG0013440	0	0	0	0	0	0	2	2
OG0013441	0	0	0	0	0	0	2	2
OG0013442	0	0	0	0	0	0	2	2
OG0013443	0	0	0	0	0	0	2	2
OG0013444	0	0	0	0	0	0	2	2
OG0013445	0	0	0	0	0	0	2	2
OG0013446	0	0	0	0	0	0	2	2
OG0013447	0	0	0	0	0	0	2	2
OG0013448	0	0	0	0	0	0	2	2
OG0013449	0	0	0	0	0	0	2	2
OG0013450	0	0	0	0	0	0	2	2
OG0013451	0	0	0	0	0	0	2	2
OG0013452	0	0	0	0	0	0	2	2
OG0013453	0	0	0	0	0	0	2	2
OG0013454	0	0	0	0	0	0	2	2
OG0013455	0	0	0	0	0	0	2	2
OG0013456	0	0	0	0	0	0	2	2
OG0013457	0	0	0	0	0	0	2	2
OG0013458	0	0	0	0	0	0	2	2
OG0013459	0	0	0	0	0	0	2	2
OG0013460	0	0	0	0	0	0	2	2
OG0013461	0	0	0	0	0	0	2	2
OG0013462	0	0	0	0	0	0	2	2
OG0013463	0	0	0	0	0	0	2	2
OG0013464	0	0	0	0	0	0	2	2
OG0013465	0	0	0	0	0	0	2	2
OG0013466	0	0	0	0	0	0	2	2
OG0013467	0	0	0	0	0	0	2	2
OG0013468	0	0	0	0	0	0	2	2
OG0013469	0	0	0	0	0	0	2	2
OG0013470	0	0	0	0	0	0	2	2
OG0013471	0	0	0	0	0	0	2	2
OG0013472	0	0	0	0	0	0	2	2
OG0013473	0	0	0	0	0	0	2	2
OG0013474	0	0	0	0	0	0	2	2
OG0013475	0	0	0	0	0	0	2	2
OG0013476	0	0	0	0	0	0	2	2
OG0013477	0	0	0	0	0	0	2	2
OG0013478	0	0	0	0	0	0	2	2
OG0013479	0	0	0	0	0	0	2	2
OG0013480	0	0	0	0	0	0	2	2
OG0013481	0	0	0	0	0	0	2	2
OG0013482	0	0	0	0	0	0	2	2
OG0013483	0	0	0	0	0	0	2	2
OG0013484	0	0	0	0	0	0	2	2
OG0013485	0	0	0	0	0	0	2	2
OG0013486	0	0	0	0	0	0	2	2
OG0013487	0	0	0	0	0	0	2	2
OG0013488	0	0	0	0	0	0	2	2
OG0013489	0	0	0	0	0	0	2	2
OG0013490	0	0	0	0	0	0	2	2
OG0013491	0	0	0	0	0	0	2	2
OG0013492	0	0	0	0	0	0	2	2
OG0013493	0	0	0	0	0	0	2	2
OG0013494	0	0	0	0	0	0	2	2
OG0013495	0	0	0	0	0	0	2	2
OG0013496	0	0	0	0	0	0	2	2
OG0013497	0	0	0	0	0	0	2	2
OG0013498	0	0	0	0	0	0	2	2
OG0013499	0	0	0	0	0	0	2	2
OG0013500	0	0	0	0	0	0	2	2
OG0013501	0	0	0	0	0	0	2	2
OG0013502	0	0	0	0	0	0	2	2
OG0013503	0	0	0	0	0	0	2	2
OG0013504	0	0	0	0	0	0	2	2
OG0013505	0	0	0	0	0	0	2	2
OG0013506	0	0	0	0	0	0	2	2
OG0013507	0	0	0	0	0	0	2	2
OG0013508	0	0	0	0	0	0	2	2
OG0013509	0	0	0	0	0	0	2	2
OG0013510	0	0	0	0	0	0	2	2
OG0013511	0	0	0	0	0	0	2	2
OG0013512	0	0	0	0	0	0	2	2
OG0013513	0	0	0	0	0	0	2	2
OG0013514	0	0	0	0	0	0	2	2
OG0013515	0	0	0	0	0	0	2	2
OG0013516	0	0	0	0	0	0	2	2
OG0013517	0	0	0	0	0	0	2	2
OG0013518	0	0	0	0	0	0	2	2
OG0013519	0	0	0	0	0	0	2	2
OG0013520	0	0	0	0	0	0	2	2
OG0013521	0	0	0	0	0	0	2	2
OG0013522	0	0	0	0	0	0	2	2
OG0013523	0	0	0	0	0	0	2	2
OG0013524	0	0	0	0	0	0	2	2
OG0013525	0	0	0	0	0	0	2	2
OG0013526	0	0	0	0	0	0	2	2
OG0013527	0	0	0	0	0	0	2	2
OG0013528	0	0	0	0	0	0	2	2
OG0013529	0	0	0	0	0	0	2	2
OG0013530	0	0	0	0	0	0	2	2
OG0013531	0	0	0	0	0	0	2	2
OG0013532	0	0	0	0	0	0	2	2
OG0013533	0	0	0	0	0	0	2	2
OG0013534	0	0	0	0	0	0	2	2
OG0013535	0	0	0	0	0	0	2	2
OG0013536	0	0	0	0	0	0	2	2
OG0013537	0	0	0	0	0	0	2	2
OG0013538	0	0	0	0	0	0	2	2
OG0013539	0	0	0	0	0	0	2	2
OG0013540	0	0	0	0	0	0	2	2
OG0013541	0	0	0	0	0	0	2	2
OG0013542	0	0	0	0	0	0	2	2
OG0013543	0	0	0	0	0	0	2	2
OG0013544	0	0	0	0	0	0	2	2
OG0013545	0	0	0	0	0	0	2	2
OG0013546	0	0	0	0	0	0	2	2
OG0013547	0	0	0	0	0	0	2	2
OG0013548	0	0	0	0	0	0	2	2
OG0013549	0	0	0	0	0	0	2	2
OG0013550	0	0	0	0	0	0	2	2
OG0013551	0	0	0	0	0	0	2	2
OG0013552	0	0	0	0	0	0	2	2
OG0013553	0	0	0	0	0	0	2	2
OG0013554	0	0	0	0	0	0	2	2
OG0013555	0	0	0	0	0	0	2	2
OG0013556	0	0	0	0	0	0	2	2
OG0013557	0	0	0	0	0	0	2	2
OG0013558	0	0	0	0	0	0	2	2
OG0013559	0	0	0	0	0	0	2	2
OG0013560	0	0	0	0	0	0	2	2
OG0013561	0	0	0	0	0	0	2	2
OG0013562	0	0	0	0	0	0	2	2
OG0013563	0	0	0	0	0	0	2	2
OG0013564	0	0	0	0	0	0	2	2
OG0013565	0	0	0	0	0	0	2	2
OG0013566	0	0	0	0	0	0	2	2
OG0013567	0	0	0	0	0	0	2	2
OG0013568	0	0	0	0	0	0	2	2
OG0013569	0	0	0	0	0	0	2	2
OG0013570	0	0	0	0	0	0	2	2
OG0013571	0	0	0	0	0	0	2	2
OG0013572	0	0	0	0	0	0	2	2
OG0013573	0	0	0	0	0	0	2	2
OG0013574	0	0	0	0	0	0	2	2
OG0013575	0	0	0	0	0	0	2	2
OG0013576	0	0	0	0	0	0	2	2
OG0013577	0	0	0	0	0	0	2	2
OG0013578	0	0	0	0	0	0	2	2
OG0013579	0	0	0	0	0	0	2	2
OG0013580	0	0	0	0	0	0	2	2
OG0013581	0	0	0	0	0	0	2	2
OG0013582	0	0	0	0	0	0	2	2
OG0013583	0	0	0	0	0	0	2	2
OG0013584	0	0	0	0	0	0	2	2
OG0013585	0	0	0	0	0	0	2	2
OG0013586	0	0	0	0	0	0	2	2
OG0013587	0	0	0	0	0	0	2	2
OG0013588	0	0	0	0	0	0	2	2
OG0013589	0	0	0	0	0	0	2	2
OG0013590	0	0	0	0	0	0	2	2
OG0013591	0	0	0	0	0	0	2	2
OG0013592	0	0	0	0	0	0	2	2
OG0013593	0	0	0	0	0	0	2	2
OG0013594	0	0	0	0	0	0	2	2
OG0013595	0	0	0	0	0	0	2	2
OG0013596	0	0	0	0	0	0	2	2
OG0013597	0	0	0	0	0	0	2	2
OG0013598	0	0	0	0	0	0	2	2
OG0013599	0	0	0	0	0	0	2	2
OG0013600	0	0	0	0	0	0	2	2
OG0013601	0	0	0	0	0	0	2	2
OG0013602	0	0	0	0	0	0	2	2
OG0013603	0	0	0	0	0	0	2	2
OG0013604	0	0	0	0	0	0	2	2
OG0013605	0	0	0	0	0	0	2	2
OG0013606	0	0	0	0	0	0	2	2
OG0013607	0	0	0	0	0	0	2	2
OG0013608	0	0	0	0	0	0	2	2
OG0013609	0	0	0	0	0	0	2	2
OG0013610	0	0	0	0	0	0	2	2
OG0013611	0	0	0	0	0	0	2	2
OG0013612	0	0	0	0	0	0	2	2
OG0013613	0	0	0	0	0	0	2	2
OG0013614	0	0	0	0	0	0	2	2
OG0013615	0	0	0	0	0	0	2	2
OG0013616	0	0	0	0	0	0	2	2
OG0013617	0	0	0	0	0	0	2	2
OG0013618	0	0	0	0	0	0	2	2
OG0013619	0	0	0	0	0	0	2	2
OG0013620	0	0	0	0	0	0	2	2
OG0013621	0	0	0	0	0	0	2	2
OG0013622	0	0	0	0	0	0	2	2
OG0013623	0	0	0	0	0	0	2	2
OG0013624	0	0	0	0	0	0	2	2
OG0013625	0	0	0	0	0	0	2	2
OG0013626	0	0	0	0	0	0	2	2
OG0013627	0	0	0	0	0	0	2	2
OG0013628	0	0	0	0	0	0	2	2
OG0013629	0	0	0	0	0	0	2	2
OG0013630	0	0	0	0	0	0	2	2
OG0013631	0	0	0	0	0	0	2	2
OG0013632	0	0	0	0	0	0	2	2
OG0013633	0	0	0	0	0	0	2	2
OG0013634	0	0	0	0	0	0	2	2
OG0013635	0	0	0	0	0	0	2	2
OG0013636	0	0	0	0	0	0	2	2
OG0013637	0	0	0	0	0	0	2	2
OG0013638	0	0	0	0	0	0	2	2
OG0013639	0	0	0	0	0	0	2	2
OG0013640	0	0	0	0	0	0	2	2
OG0013641	0	0	0	0	0	0	2	2
OG0013642	0	0	0	0	0	0	2	2
OG0013643	0	0	0	0	0	0	2	2
